Apple	Apple ⌚️ 🎧 👨‍💻 👩‍💻 🖱
Asian	Asian 🍙 🍚 🍜 🍣 🍱 🍲 💮
British	British 🇬🇧 🇮🇴 🇻🇬 💂‍♀️ 💂‍♂️ 💷
CTO	CTO 👨‍💻 👨‍💼 👩‍💻 👩‍💼
European	European 🇪🇺 🏤 🏰 💶
French	French 🇫🇷 🇬🇫 🇵🇫 🇹🇫
I	I ☺️ 👀 👁‍🗨 🤔 🤟 🤷‍♀️ 🤷‍♂️ 🥺 😉 😍 😘 😱 😵 😻 🙂 🙌 🙏
Japan	Japan 🇯🇵 🏯 💴 🗾
Japanese	Japanese 🇯🇵 🎎 🏣 🏯 🐕 👹 👺 💴 🔰 🗾 🈁 🈂️ 🈹 🉑 🈴 🈺 🉐 🈯️ 🈷️ 🈶 🈵 🈚️ 🈸 ㊗️ 🈲 ㊙️ 🈳
New	New 🇳🇨 🇳🇿 🌵 🎉 🎊
Saint	Saint 🇧🇱 🇰🇳 🇱🇨 🇵🇲 🇸🇭 🇻🇨 🎅
South	South 🇬🇸 🇰🇷 🇸🇸 🇿🇦
United	United 🇦🇪 🇬🇧 🇺🇳 🇺🇸
a	a ☀️ ⚡️ ⛺️ 🌱 🍹 🏆 🏍 🏕 👎 💥 🤩 🥂 🥃 🙅‍♀️ 🙅‍♂️ 🅰️
accessibility	accessibility 🐕‍🦺 👨‍🦯 👨‍🦼 👨‍🦽 👩‍🦯 👩‍🦼 👩‍🦽 🦮 🦯 🦻 🦼 🦽 🦾 🦿 🧏‍♀️ 🧏‍♂️
accessory	accessory ⌚️ ⛑️ 🌂 🎒 🎓 🎖 🎗 🎩 🏅 🏵 👑 👒 👓 👔 👕 👖 👗 👘 👙 👚 👛 👜 👝 👞 👟 👠 👡 👢 💄 💍 💼 📱 📲 🕶 🖼
activity	activity ⚗️ ⚽️ ⚾️ ⛳️ ⛴️ ⛵️ ⛷️ ⛸️ ⛹️‍♀️ ⛹️‍♂️ ⛺️ ✈️ 🍳 🍻 🍼 🍾 🎃 🎣 🎤 🎧 🎪 🎬 🎭 🎮 🎯 🎰 🎱 🎲 🎳 🎷 🎸 🎹 🎺 🎻 🎼 🎾 🎿 🏀 🏂 🏄‍♀️ 🏄‍♂️ 🏇 🏈 🏉 🏊‍♀️ 🏊‍♂️ 🏋️‍♀️ 🏋️‍♂️ 🏌️‍♀️ 🏌️‍♂️ 🏍 🏎 🏏 🏐 🏑 🏒 🏓 🏕 🏸 🏹 👾 💃 💈 💉 💥 💬 💭 📖 📚 📿 🔬 🔭 🔮 🕴 🗯 🤸‍♀️ 🤸‍♂️ 🤹‍♀️ 🤹‍♂️ 🤺 🤼‍♀️ 🤼‍♂️ 🤽‍♀️ 🤽‍♂️ 🤾‍♀️ 🤾‍♂️ 🧗‍♀️ 🧗‍♂️ 🚀 🚁 🚂 🚃 🚄 🚅 🚆 🚈 🚉 🚊 🚋 🚌 🚍 🚎 🚐 🚑 🚒 🚓 🚔 🚕 🚖 🚗 🚘 🚙 🚚 🚛 🚜 🚝 🚞 🚟 🚠 🚡 🚣‍♀️ 🚣‍♂️ 🚤 🚬 🚲 🚴‍♀️ 🚴‍♂️ 🚵‍♀️ 🚵‍♂️ 🚽 🚿 🛀 🛌 🛍 🛏 🛥 🛩 🛫 🛬 🛳 🛶
adult	adult 🍶 🍷 🍸 🍹 🍺 🍻 🍾 🧑
afraid	afraid 😟 😦 😧 😨 😱 😳 🙀
air	air ♈️ ✈️ 💺 😤 🚀 🚁 🛩 🛫 🛬 🛰
airplane	airplane ✈️ 💺 🛩 🛫 🛬
alarm	alarm ⏰ ⏲ 🔔 🔕 🚨
alarmed	alarmed 😦 😧 😱 😳
alcohol	alcohol 🍶 🍷 🍸 🍹 🍺 🍻 🍾
alcoholic	alcoholic 🍶 🍷 🍸 🍹 🍺 🍻 🍾
amusement	amusement 🎟 🎠 🎡 🎢
analog	analog 🕐 🕑 🕒 🕓 🕔 🕕 🕖 🕗 🕘 🕙 🕚 🕛 🕜 🕝 🕞 🕟 🕠 🕡 🕢 🕣 🕤 🕥 🕦 🕧
angry	angry 👺 👿 🗯 😖 😠 😡 😤 😾 🙍‍♀️ 🙍‍♂️
animal	animal 🏇 🐀 🐁 🐂 🐃 🐄 🐅 🐆 🐇 🐈 🐉 🐊 🐋 🐌 🐍 🐎 🐏 🐐 🐑 🐒 🐓 🐔 🐕 🐕‍🦺 🐖 🐗 🐘 🐙 🐚 🐛 🐜 🐝 🐞 🐟 🐠 🐡 🐢 🐣 🐤 🐥 🐦 🐧 🐨 🐩 🐪 🐫 🐬 🐭 🐮 🐯 🐰 🐱 🐲 🐳 🐴 🐵 🐶 🐷 🐸 🐹 🐺 🐻 🐼 🐽 🐾 🐿 🕊 🕷 🕸 🦀 🦁 🦂 🦃 🦄 🦅 🦆 🦇 🦈 🦉 🦊 🦋 🦌 🦎 🦏 🦑 🦒 🦓 🦔 🦕 🦖 🦗 🦘 🦙 🦚 🦛 🦜 🦝 🦞 🦡 🦢 🦥 🦦 🦧 🦨 🦩 🦮 😸 😹 😺 😻 😼 😽 😾 😿 🙀 🙈 🙉 🙊
animals	animals 🐕‍🦺 🐘 🦘 🦙 🦚 🦛 🦜 🦝 🦞 🦡 🦢 🦥 🦦 🦧 🦨 🦩 🦮
annoyed	annoyed 😑 😒 😠 🙄
anxious	anxious 🥺 😟 😥 😦 😧 😩 😫 😰
appalled	appalled 😦 😧 😮 😯 😲 😳
apple	apple ⌚️ 🎧 👨‍💻 👩‍💻 🖱
argh	argh 😖 😣 😤 😫
arrow	arrow ↔️ ↕️ ↖️ ↗️ ↘️ ↙️ ↩️ ↪️ ⏫ ⏬ ◀️ ➡️ ⤴️ ⤵️ ⬅️ ⬆️ ⬇️ 🏹 💘 📩 🔙 🔚 🔛 🔜 🔝 🔰 🔼 🔽
arrows	arrows ⏩ ⏪ ⏭️ ⏮️ 🔀 🔁 🔂 🔃 🔄
art	art 🎨 🎭 🖌 🖼
artist	artist 🎨 👨‍🎤 👨‍🎨 👩‍🎤 👩‍🎨 🖌 🧑‍🎨
asian	asian 🍙 🍚 🍜 🍣 🍱 🍲 💮
astonished	astonished 😦 😧 😮 😯 😲 😳
astounded	astounded 😮 😯 😲 😳
astrological	astrological 🐂 🐏 🐐 🦀 🦂
astronaut	astronaut 👨‍🚀 👩‍🚀 🧑‍🚀 🚀 🛰
astronomy	astronomy ☄️ ⭐️ 🌍 🌏 🌑 🌒 🌓 🌔 🌕 🌖 🌗 🌘 🌙 🌚 🌛 🌜 🌝 🌞 🌟 💫 🔭 🪐
athlete	athlete ⛷ ⛹️‍♀️ ⛹️‍♂️ 🏂 🏄‍♀️ 🏄‍♂️ 🏇 🏊‍♀️ 🏊‍♂️ 🏋️‍♂️ 🧗‍♀️ 🧗‍♂️ 🚣‍♀️ 🚣‍♂️ 🚴‍♀️ 🚴‍♂️ 🚵‍♀️ 🚵‍♂️
athletic	athletic ⚽️ ⚾️ ⛳️ ⛷️ ⛸️ ⛹️‍♀️ ⛹️‍♂️ 🎣 🎱 🎽 🎾 🎿 🏀 🏂 🏄‍♀️ 🏄‍♂️ 🏅 🏇 🏈 🏉 🏊‍♀️ 🏊‍♂️ 🏋️‍♀️ 🏋️‍♂️ 🏌️‍♀️ 🏌️‍♂️ 🏏 🏐 🏑 🏒 🏓 🏸 🏹 👟 🧗‍♀️ 🧗‍♂️ 🚣‍♀️ 🚣‍♂️ 🚴‍♀️ 🚴‍♂️ 🚵‍♀️ 🚵‍♂️
autumn	autumn 🍁 🍂 🍃 🥮
award	award 🎖 🏅 🏆 🥇 🥈 🥉
baby	baby 🍼 🐣 🐤 🐥 🐯 🐱 👶 👼 🚼
back	back ⏪ ⏮️ 💳 🔙 🤚
backhand	backhand 👆 👇 👈 👉
bad	bad ☁️ ⛈ 🌥 🌦 🌧 🌩 👎 😒 😷 🙅‍♀️ 🙅‍♂️
baffled	baffled 😕 😮 😯 😲
bag	bag 🍿 🎒 👛 👜 👝 💰 💼 🧳
baggage	baggage 🧳 🚃 🛄 🛅
ball	ball ☄️ ⚽️ ⚾️ ⛳️ 🎱 🎳 🎾 🏀 🏈 🏉 🏏 🏐 🏑 🏓 🏸 🥎 🧶
baller	baller ⛹️‍♀️ ⛹️‍♂️ 🤑 😎
balls	balls ☄️ ⚽️ ⚾️ 🎱 🎾 🏀 🏈 🏐 🥎 🧶
banded	banded 💴 💵 💶 💷
bank	bank 🏦 🏧 💳 💸
bar	bar 🎯 📈 📉 📊 🧼
basketball	basketball ⛹️ ⛹️‍♀️ ⛹️‍♂️ 🏀
bath	bath 🧼 🧽 🛀 🛁
bathing	bathing 👙 🧼 🧽 🩱 🩳 🛀 🛁
baths	baths 🧼 🧽 🛀 🛁
beverage	beverage ☕️ 🍲 🍵 🍶 🍷 🍸 🍹 🍺 🍻 🍾 🧃 🧉
bicycle	bicycle 🚲 🚴‍♀️ 🚴‍♂️ 🚵‍♀️ 🚵‍♂️
bicycling	bicycling 🚲 🚴‍♀️ 🚴‍♂️ 🚵‍♀️ 🚵‍♂️
bicyclist	bicyclist 🚴‍♀️ 🚴‍♂️ 🚵‍♀️ 🚵‍♂️
bicyclists	bicyclists 🚴‍♀️ 🚴‍♂️ 🚵‍♀️ 🚵‍♂️
big	big ☹️ 🤣 😀 😂 😃 😄 😅 😆 🚛
bike	bike 🚲 🚴‍♀️ 🚴‍♂️ 🚵‍♀️ 🚵‍♂️
biker	biker 🚴‍♀️ 🚴‍♂️ 🚵‍♀️ 🚵‍♂️
bikers	bikers 🚴‍♀️ 🚴‍♂️ 🚵‍♀️ 🚵‍♂️
biking	biking 🚲 🚴‍♀️ 🚴‍♂️ 🚵‍♀️ 🚵‍♂️
biology	biology 🔬 🧪 🧫 🧬
bird	bird 🐦 🐧 🦅 🦆 🦉 🦚 🦜 🦢 🦩
birds	birds 🐦 🦅 🦚 🦜 🦢 🦩
birthday	birthday 🍰 🎁 🎂 🎈 🎉 🎊 🥳
birthdays	birthdays 🍰 🎂 🎈 🎉 🎊
black	black ▪️ ◼️ ◾️ ☕️ ♠️ ♣️ ⚫️ ⬛️ 🏴 🏴‍☠️ 👓 📓 🔲 🖤 🥋
blind	blind 👨‍🦯 👩‍🦯 🦮 🦯
blood	blood 🩸 🅰️ 🆎 🅱️ 🅾️
blossom	blossom 🌷 🌸 🌹 🌺 🌻 🌼
blowing	blowing 🌬 🤧 😗 😘 😙 😚
blue	blue 🍹 🎽 🏅 🐳 👔 👕 👖 👮‍♂️ 💙 📘 🔵 🔷 🔹 🥶 🦋 🧢 😨 😰 😱 🚙 🟦
blushing	blushing ☺️ 👰 🤗 🤭 😊 😚
board	board ♟️ 🎯 🎲 🏂
boat	boat ⚓️ ⛵️ 🚢 🚣‍♀️ 🚣‍♂️ 🚤
boating	boating ⛵️ 🚤 🛥 🛶
boats	boats ⛵️ 🚣‍♀️ 🚣‍♂️ 🚤
body	body 👀 👁 👂 👃 👄 👅 👣 👤 👥 🗣 🦵 🦶 🧴
book	book 📒 📓 📔 📕 📖 📗 📘 📙 📚 🔖
bottle	bottle 🍶 🍼 🍾 🧨
bow	bow 🎀 🎗 🏹 💝 🙇‍♀️ 🙇‍♂️
bowl	bowl 🍚 🍜 🍨 🍲 🍿 🥣
box	box *️⃣ #️⃣ ↔️ ↕️ ↖️ ↗️ ↘️ ↙️ ↩️ ↪️ ⏩ ⏪ ⏫ ⏬ ⏭️ ⏮️ ⏯️ ⏸️ ⏹️ ⏺️ ▶️ ◀️ ☑️ ☢️ ☣️ ☦️ ☪️ ☮️ ☯️ ☸️ ♈️ ♉️ ♊️ ♋️ ♌️ ♍️ ♎️ ♏️ ♐️ ♑️ ♒️ ♓️ ♿️ ⚛️ ⛎ ✅ ✝️ ✡️ ✳️ ✴️ ❇️ ❎ ➡️ ➿ ⤴️ ⤵️ ⬅️ ⬆️ ⬇️ 🎁 🎦 🏧 💟 💹 📤 📥 📦 📪 📫 📬 📭 📮 📳 📴 📶 🔀 🔁 🔂 🔄 🔟 🔠 🔡 🔢 🔣 🔤 🔯 🔼 🔽 🕉 🕎 🗃 🗄 🗳 🚭 🚮 🚹 🚺 🚻 🚼 🚾 🛂 🛃 🛄 🛅 🛐 0️⃣ 1️⃣ 2️⃣ 3️⃣ 4️⃣ 5️⃣ 6️⃣ 7️⃣ 8️⃣ 9️⃣ 🅰️ 🆎 🅱️ 🆑 🆒 🆓 ℹ️ 🆔 🆕 🆖 🅾️ 🆗 🅿️ 🆘 🆙 🆚 🈁 🈂️ 🈹 🈴 🈺 🈯️ 🈷️ 🈶 🈵 🈚️ 🈸 🈲 🈳
boy	boy 🏃‍♂️ 👦 👨‍❤️‍👨 👨‍❤️‍💋‍👨 👩‍❤️‍💋‍👨 💆‍♂️ 💇‍♂️ 💏 💑 🤴 🧗‍♂️ 🙅‍♂️ 🙆‍♂️ 🙇‍♂️ 🙋‍♂️ 🙍‍♂️ 🙎‍♂️ 🚶‍♂️
british	british 🇬🇧 🇮🇴 🇻🇬 💂‍♀️ 💂‍♂️ 💷
brown	brown 🍂 👞 📦 🤎 🟤 🟫
bud	bud 🌷 🌸 🌹 🌺 🌻 🌼
bug	bug 🐛 🐜 🐞 🕷 🦟
bugs	bugs 🐛 🐜 🐞 🕷 🦟
building	building ⛩️ ⛪️ 🏗 🏘 🏚 🏛 🏟 🏠 🏡 🏢 🏣 🏤 🏥 🏦 🏨 🏩 🏪 🏫 🏬 🏯 🏰 💒 🕋 🕌 🕍 🗼
bummed	bummed ☹️ 😔 😞 🙁
bus	bus 🚌 🚍 🚎 🚏 🚐
business	business ✂️ 📁 📂 📃 📄 📅 📆 📇 📈 📉 📊 📋 📌 📍 📎 📏 📐 📑 📜 📤 📥 🕴 🖇 🗂 🗃 🗄 🗒 🗓 🗳
button	button ◻️ ◼️ ◽️ ◾️ ☑️ 👕 👚 📢 📣 🔅 🔆 🔇 🔈 🔉 🔊 🔔 🔕 🔘 🔲 🔳
cake	cake 🍥 🍰 🎂 🥮 🧁
cakes	cakes 🍰 🎂 🥮 🧁
camera	camera 🎞 🎥 📷 📸 📹 📽 🤳
candy	candy 🍩 🍪 🍫 🍬 🍭
cap	cap 🎓 🎩 👒 🧢
car	car 🏁 🚍 🚔 🚕 🚖 🚗 🚘 🚙
card	card 💳 📇 🗂 🗃
cards	cards ♠️ ♣️ ♥️ ♦️ 🃏 🎴 📇
carnival	carnival 🎟 🎠 🎡 🎢
cash	cash 💰 💴 💵 💶 💸 🤑
cat	cat 🐈 🐱 😸 😹 😺 😻 😼 😽 😾 😿 🙀
celebration	celebration 🍾 🎁 🎉 🎊 👏 🥂 🥳 🙌 🙏
chart	chart 💹 📈 📉 📊
check	check ☑️ ✅ ✔️ 🧾
cheerful	cheerful 😀 😁 😃 😄
chicken	chicken 🍗 🍜 🍲 🐓 🐔
chocolate	chocolate 🍩 🍪 🍫 💝
circle	circle ⏺️ ☢️ ☣️ ⚪️ ⚫️ ⛔️ ⭕️ 💮 📛 📵 🔘 🔞 🔴 🔵 🚫 🚯 🚱 🚳 🚷 🟠 🟡 🟢 🟣 🟤 🉑 🉐 ㊗️ ㊙️
circles	circles 🟠 🟡 🟢 🟣 🟤
circus	circus 🎟 🎠 🎡 🎢 🎪
city	city 🌃 🌆 🌇 🌉 🏙 🏢
cityscape	cityscape 🌃 🌆 🌇 🏙
clean	clean 🏋️‍♀️ 🏋️‍♂️ 🧹 🧼 🧽 🛀
cleaning	cleaning 🧹 🧻 🧼 🧽
clock	clock ⌚️ ⏰ ⏱️ ⏲️ 🕐 🕑 🕒 🕓 🕔 🕕 🕖 🕗 🕘 🕙 🕚 🕛 🕜 🕝 🕞 🕟 🕠 🕡 🕢 🕣 🕤 🕥 🕦 🕧 🕰
closed	closed 🌂 👊 📁 📪 📫 🔏 🔐 🔒 😓
clothes	clothes 👔 👕 👖 👗 👘 👙 👚 👞 👟 👠 👡 👢 🥋 🥻 🥼 🦺 🩱 🩲 🩳
clothing	clothing 🎽 👔 👕 👖 👗 👘 👙 👚 👞 👟 👠 👡 👢 🥻 🥼 🦺 🧥 🩱 🩲 🩳
cloud	cloud ☁️ ⛅️ ⛈️ 🌁 🌤 🌥 🌦 🌧 🌨 🌩 🌪 💨
cloudy	cloudy ☁️ ⛅️ 🌤 🌥 🌦
cold	cold 🍦 🍧 🍨 🥶 🧊 😰
commute	commute 🏍 🚌 🚎 🚕 🚗 🚙 🚲
computer	computer ⌨️ 🎒 🎮 👨‍💻 👩‍💻 👾 💻 💼 🖥 🖱 🖲
concerned	concerned 😟 😦 😧 😱 😳
confused	confused 🤷‍♀️ 🤷‍♂️ 😐 😕
constable	constable 👮‍♀️ 👮‍♂️ 💂‍♀️ 💂‍♂️
construction	construction ⛑️ 🏗 👷 👷‍♀️ 👷‍♂️ 🚧
cop	cop 👮‍♀️ 👮‍♂️ 🚓 🚔
cops	cops 👮‍♀️ 👮‍♂️ 🚓 🚔
countries	countries 🇦🇩 🇦🇪 🇦🇫 🇦🇬 🇦🇮 🇦🇱 🇦🇲 🇦🇴 🇦🇶 🇦🇷 🇦🇸 🇦🇹 🇦🇺 🇦🇼 🇦🇽 🇦🇿 🇧🇦 🇧🇧 🇧🇩 🇧🇪 🇧🇫 🇧🇬 🇧🇭 🇧🇮 🇧🇯 🇧🇱 🇧🇲 🇧🇳 🇧🇴 🇧🇶 🇧🇷 🇧🇸 🇧🇹 🇧🇼 🇧🇾 🇧🇿 🇨🇦 🇨🇨 🇨🇩 🇨🇫 🇨🇬 🇨🇭 🇨🇮 🇨🇰 🇨🇱 🇨🇲 🇨🇳 🇨🇴 🇨🇷 🇨🇺 🇨🇻 🇨🇼 🇨🇽 🇨🇾 🇨🇿 🇩🇪 🇩🇯 🇩🇰 🇩🇲 🇩🇴 🇩🇿 🇪🇨 🇪🇪 🇪🇬 🇪🇭 🇪🇷 🇪🇸 🇪🇹 🇪🇺 🇫🇮 🇫🇯 🇫🇰 🇫🇲 🇫🇴 🇫🇷 🇬🇦 🇬🇧 🇬🇩 🇬🇪 🇬🇫 🇬🇬 🇬🇭 🇬🇮 🇬🇱 🇬🇲 🇬🇳 🇬🇵 🇬🇶 🇬🇷 🇬🇸 🇬🇹 🇬🇺 🇬🇼 🇬🇾 🇭🇰 🇭🇳 🇭🇷 🇭🇹 🇭🇺 🇮🇨 🇮🇩 🇮🇪 🇮🇱 🇮🇲 🇮🇳 🇮🇴 🇮🇶 🇮🇷 🇮🇸 🇮🇹 🇯🇪 🇯🇲 🇯🇴 🇯🇵 🇰🇪 🇰🇬 🇰🇭 🇰🇮 🇰🇲 🇰🇳 🇰🇵 🇰🇷 🇰🇼 🇰🇾 🇰🇿 🇱🇦 🇱🇧 🇱🇨 🇱🇮 🇱🇰 🇱🇷 🇱🇸 🇱🇹 🇱🇺 🇱🇻 🇱🇾 🇲🇦 🇲🇨 🇲🇩 🇲🇪 🇲🇬 🇲🇭 🇲🇰 🇲🇱 🇲🇲 🇲🇳 🇲🇴 🇲🇵 🇲🇶 🇲🇷 🇲🇸 🇲🇹 🇲🇺 🇲🇻 🇲🇼 🇲🇽 🇲🇾 🇲🇿 🇳🇦 🇳🇨 🇳🇪 🇳🇫 🇳🇬 🇳🇮 🇳🇱 🇳🇴 🇳🇵 🇳🇷 🇳🇺 🇳🇿 🇴🇲 🇵🇦 🇵🇪 🇵🇫 🇵🇬 🇵🇭 🇵🇰 🇵🇱 🇵🇲 🇵🇳 🇵🇷 🇵🇸 🇵🇹 🇵🇼 🇵🇾 🇶🇦 🇷🇪 🇷🇴 🇷🇸 🇷🇺 🇷🇼 🇸🇦 🇸🇧 🇸🇨 🇸🇩 🇸🇪 🇸🇬 🇸🇭 🇸🇮 🇸🇰 🇸🇱 🇸🇲 🇸🇳 🇸🇴 🇸🇷 🇸🇸 🇸🇹 🇸🇻 🇸🇽 🇸🇾 🇸🇿 🇹🇨 🇹🇩 🇹🇫 🇹🇬 🇹🇭 🇹🇯 🇹🇰 🇹🇱 🇹🇲 🇹🇳 🇹🇴 🇹🇷 🇹🇹 🇹🇻 🇹🇼 🇹🇿 🇺🇦 🇺🇬 🇺🇸 🇺🇾 🇺🇿 🇻🇦 🇻🇨 🇻🇪 🇻🇬 🇻🇮 🇻🇳 🇻🇺 🇼🇫 🇼🇸 🇽🇰 🇾🇪 🇾🇹 🇿🇦 🇿🇲 🇿🇼
country	country 🇦🇩 🇦🇪 🇦🇫 🇦🇬 🇦🇮 🇦🇱 🇦🇲 🇦🇴 🇦🇶 🇦🇷 🇦🇸 🇦🇹 🇦🇺 🇦🇼 🇦🇽 🇦🇿 🇧🇦 🇧🇧 🇧🇩 🇧🇪 🇧🇫 🇧🇬 🇧🇭 🇧🇮 🇧🇯 🇧🇱 🇧🇲 🇧🇳 🇧🇴 🇧🇶 🇧🇷 🇧🇸 🇧🇹 🇧🇼 🇧🇾 🇧🇿 🇨🇦 🇨🇨 🇨🇩 🇨🇫 🇨🇬 🇨🇭 🇨🇮 🇨🇰 🇨🇱 🇨🇲 🇨🇳 🇨🇴 🇨🇷 🇨🇺 🇨🇻 🇨🇼 🇨🇽 🇨🇾 🇨🇿 🇩🇪 🇩🇯 🇩🇰 🇩🇲 🇩🇴 🇩🇿 🇪🇨 🇪🇪 🇪🇬 🇪🇭 🇪🇷 🇪🇸 🇪🇹 🇪🇺 🇫🇮 🇫🇯 🇫🇰 🇫🇲 🇫🇴 🇫🇷 🇬🇦 🇬🇧 🇬🇩 🇬🇪 🇬🇫 🇬🇬 🇬🇭 🇬🇮 🇬🇱 🇬🇲 🇬🇳 🇬🇵 🇬🇶 🇬🇷 🇬🇸 🇬🇹 🇬🇺 🇬🇼 🇬🇾 🇭🇰 🇭🇳 🇭🇷 🇭🇹 🇭🇺 🇮🇨 🇮🇩 🇮🇪 🇮🇱 🇮🇲 🇮🇳 🇮🇴 🇮🇶 🇮🇷 🇮🇸 🇮🇹 🇯🇪 🇯🇲 🇯🇴 🇯🇵 🇰🇪 🇰🇬 🇰🇭 🇰🇮 🇰🇲 🇰🇳 🇰🇵 🇰🇷 🇰🇼 🇰🇾 🇰🇿 🇱🇦 🇱🇧 🇱🇨 🇱🇮 🇱🇰 🇱🇷 🇱🇸 🇱🇹 🇱🇺 🇱🇻 🇱🇾 🇲🇦 🇲🇨 🇲🇩 🇲🇪 🇲🇬 🇲🇭 🇲🇰 🇲🇱 🇲🇲 🇲🇳 🇲🇴 🇲🇵 🇲🇶 🇲🇷 🇲🇸 🇲🇹 🇲🇺 🇲🇻 🇲🇼 🇲🇽 🇲🇾 🇲🇿 🇳🇦 🇳🇨 🇳🇪 🇳🇫 🇳🇬 🇳🇮 🇳🇱 🇳🇴 🇳🇵 🇳🇷 🇳🇺 🇳🇿 🇴🇲 🇵🇦 🇵🇪 🇵🇫 🇵🇬 🇵🇭 🇵🇰 🇵🇱 🇵🇲 🇵🇳 🇵🇷 🇵🇸 🇵🇹 🇵🇼 🇵🇾 🇶🇦 🇷🇪 🇷🇴 🇷🇸 🇷🇺 🇷🇼 🇸🇦 🇸🇧 🇸🇨 🇸🇩 🇸🇪 🇸🇬 🇸🇭 🇸🇮 🇸🇰 🇸🇱 🇸🇲 🇸🇳 🇸🇴 🇸🇷 🇸🇸 🇸🇹 🇸🇻 🇸🇽 🇸🇾 🇸🇿 🇹🇨 🇹🇩 🇹🇫 🇹🇬 🇹🇭 🇹🇯 🇹🇰 🇹🇱 🇹🇲 🇹🇳 🇹🇴 🇹🇷 🇹🇹 🇹🇻 🇹🇼 🇹🇿 🇺🇦 🇺🇬 🇺🇳 🇺🇸 🇺🇾 🇺🇿 🇻🇦 🇻🇨 🇻🇪 🇻🇬 🇻🇮 🇻🇳 🇻🇺 🇼🇫 🇼🇸 🇽🇰 🇾🇪 🇾🇹 🇿🇦 🇿🇲 🇿🇼
couple	couple 👨‍❤️‍👨 👩‍❤️‍👨 👩‍❤️‍👩 💑
cross	cross ☦️ ⛷️ ✝️ ❌ 🎿 😵 🚴‍♀️ 🚴‍♂️
crying	crying 🤣 😂 😢 😭 😿
cto	cto 👨‍💻 👨‍💼 👩‍💻 👩‍💼
cup	cup ☕️ 🍜 🍨 🍵 🍶 🍼 🥤
curly	curly ➰ ➿ 🌀 👨‍🦱 👩‍🦱 🦱
curve	curve ↩️ ↪️ ⤴️ ⤵️
cut	cut 🎬 💇‍♀️ 💇‍♂️ 🥩
cute	cute 👨‍❤️‍👨 👨‍❤️‍💋‍👨 👩‍❤️‍👨 👩‍❤️‍👩 👩‍❤️‍💋‍👨 👩‍❤️‍💋‍👩 💏 💑
cycling	cycling 🚴‍♀️ 🚴‍♂️ 🚵‍♀️ 🚵‍♂️
cyclist	cyclist 🚴 🚴‍♀️ 🚴‍♂️ 🚵‍♀️ 🚵‍♂️
cyclists	cyclists 🚴‍♀️ 🚴‍♂️ 🚵‍♀️ 🚵‍♂️
dad	dad 👨‍👦 👨‍👦‍👦 👨‍👧 👨‍👧‍👦 👨‍👧‍👧 👨‍👨‍👦 👨‍👨‍👦‍👦 👨‍👨‍👧 👨‍👨‍👧‍👦 👨‍👨‍👧‍👧 👨‍👩‍👦‍👦 👨‍👩‍👧 👨‍👩‍👧‍👦 👨‍👩‍👧‍👧 👪
dance	dance 👯‍♀️ 👯‍♂️ 💃 🩰
dancing	dancing 👯 👯‍♀️ 👯‍♂️ 💃 🕺 🩰
daughter	daughter 👨‍👧 👨‍👧‍👧 👨‍👨‍👧 👨‍👨‍👧‍👦 👨‍👨‍👧‍👧 👨‍👩‍👧‍👦 👨‍👩‍👧‍👧 👩‍👧 👩‍👧‍👦 👩‍👧‍👧 👩‍👩‍👧 👩‍👩‍👧‍👦 👩‍👩‍👧‍👧
day	day ⛰️ 🌁 🌞 🏕 🏙 💭
dead	dead 🏋️‍♂️ 🏴‍☠️ 💀 😵
death	death ☠️ ⚰️ ⚱️ 💀
decoration	decoration 🎍 🎐 🎖 🎗 🏅 🏵 🖼
dejected	dejected ☹️ 😔 😞 😩 🙁
delighted	delighted 😀 😁 😃 😄
delivery	delivery 📦 🚐 🚚 🚛
desert	desert 🌵 🍡 🏜 🏝 🐪 🐫 🦂
dessert	dessert 🍦 🍧 🍨 🍩 🍪 🍫 🍬 🍭 🍮 🍯 🍰 🎂 🥮 🧁
desserts	desserts 🍨 🍮 🥮 🧁
devil	devil 👹 👺 👿 😈
diamond	diamond ♦️ 💍 💎 💠 🔶 🔷 🔸 🔹 🚸
dinner	dinner 🌭 🌮 🌯 🍔 🍕 🍛 🍜 🍝 🍱 🍲 🍴 🍽 🥗 🥘
directions	directions ☝️ 👆 👇 👈 👉 🔄 🖐 🖕 🧭
disappointed	disappointed ☹️ 😔 😞 😥 🙁 🙎‍♀️ 🙎‍♂️
disc	disc 💽 💿 📀 🥏
distressed	distressed 🤮 😟 😩 😫
doctor	doctor 👨‍⚕️ 👩‍⚕️ 🥼 🩺
document	document 📃 📄 📈 📉 📊 📑
dog	dog 🐕 🐕‍🦺 🐩 🐶 🦮 🦴
dogs	dogs 🐕 🐕‍🦺 🐶 🦮
don	don 🤦‍♀️ 🤦‍♂️ 🤷‍♀️ 🤷‍♂️ 😉 🙌 🚭 🚮
double	double ⏫ ⏬ ➿ 🧬 🧹
down	down ↘️ ↙️ ⏬ ⤵️ ⬇️ 👇 👎 🔰 🔻 🔽
downcast	downcast ☹️ 😔 😞 🙁
drawing	drawing ✍️ 🎟 🎨 🩸
dreary	dreary ☹️ 😔 😞 🙁
dress	dress 👔 👗 👘 👞 🥻
drink	drink 🍷 🍸 🍹 🍻 🥃 🥛 🥤 🧃 🧉
drinks	drinks ☕️ 🍵 🍶 🍷 🍸 🍹 🍺 🍻 🍼 🍾 🥤 🧃 🧉
driving	driving 🏍 🏎 🚕 🚗 🚙
duck	duck 🐣 🐤 🐥 🤬 🦆 😗 😙 😚
ear	ear 🌽 🌾 👂 🦻
eight	eight ✳️ ✴️ 🎱 🕗 🕣 8️⃣
electric	electric ⚡️ 🎸 💡 🔌 🔦 🚎
embarrassed	embarrassed 😞 😩 😳 🙈
emergency	emergency 🏥 🦺 🚑 🚒 🚓 🚨
emoji	emoji ☝️ ☹️ ☺️ ✊ ✋ ✌️ ✍️ 🎅 🏃‍♀️ 🏃‍♂️ 🏄‍♀️ 🏊‍♀️ 🏋️‍♀️ 🏌️‍♀️ 👆 👇 👈 👉 👊 👋 👌 👍 👎 👏 👐 👦 👧 👨 👨‍❤️‍👨 👨‍❤️‍💋‍👨 👨‍👦 👨‍👦‍👦 👨‍👧 👨‍👧‍👦 👨‍👧‍👧 👨‍👨‍👦 👨‍👨‍👦‍👦 👨‍👨‍👧 👨‍👨‍👧‍👦 👨‍👨‍👧‍👧 👨‍👩‍👦 👨‍👩‍👦‍👦 👨‍👩‍👧 👨‍👩‍👧‍👦 👨‍👩‍👧‍👧 👩 👩‍❤️‍👨 👩‍❤️‍👩 👩‍❤️‍💋‍👨 👩‍❤️‍💋‍👩 👩‍👦 👩‍👦‍👦 👩‍👧 👩‍👧‍👦 👩‍👧‍👧 👩‍👩‍👦 👩‍👩‍👦‍👦 👩‍👩‍👧 👩‍👩‍👧‍👦 👩‍👩‍👧‍👧 👪 👮‍♀️ 👮‍♂️ 👯‍♀️ 👯‍♂️ 👰 👱‍♀️ 👱‍♂️ 👲 👳‍♀️ 👳‍♂️ 👴 👵 👶 👷‍♀️ 👷‍♂️ 👸 👹 👺 👻 👼 👽 👿 💀 💁‍♀️ 💁‍♂️ 💂‍♀️ 💂‍♂️ 💃 💅 💆‍♀️ 💆‍♂️ 💇‍♀️ 💇‍♂️ 💏 💑 💩 💪 🕵️‍♀️ 🕵️‍♂️ 🖐 🖕 🖖 🤐 🤑 🤒 🤓 🤔 🤕 🤖 🤗 🤘 🤣 🤤 🤥 🤧 😀 😁 😂 😃 😄 😅 😆 😇 😈 😉 😊 😋 😌 😍 😎 😏 😐 😑 😒 😓 😔 😕 😖 😗 😘 😙 😚 😛 😜 😝 😞 😟 😠 😡 😢 😣 😤 😥 😦 😧 😨 😩 😪 😫 😬 😭 😮 😯 😰 😱 😲 😳 😴 😵 😶 😷 😸 😹 😺 😻 😼 😽 😾 😿 🙀 🙁 🙂 🙃 🙄 🙅‍♀️ 🙅‍♂️ 🙆‍♀️ 🙆‍♂️ 🙇‍♀️ 🙇‍♂️ 🙋‍♀️ 🙋‍♂️ 🙌 🙍‍♀️ 🙍‍♂️ 🙎‍♀️ 🙎‍♂️ 🙏 🚶‍♀️ 🚶‍♂️
emoticon	emoticon ☝️ ☹️ ☺️ ✊ ✋ ✌️ ✍️ 🎅 🏃‍♀️ 🏃‍♂️ 🏄‍♀️ 🏊‍♀️ 🏋️‍♀️ 🏌️‍♀️ 👆 👇 👈 👉 👊 👋 👌 👍 👎 👏 👐 👦 👧 👨 👨‍❤️‍👨 👨‍❤️‍💋‍👨 👨‍👦 👨‍👦‍👦 👨‍👧 👨‍👧‍👦 👨‍👧‍👧 👨‍👨‍👦 👨‍👨‍👦‍👦 👨‍👨‍👧 👨‍👨‍👧‍👦 👨‍👨‍👧‍👧 👨‍👩‍👦 👨‍👩‍👦‍👦 👨‍👩‍👧 👨‍👩‍👧‍👦 👨‍👩‍👧‍👧 👩 👩‍❤️‍👨 👩‍❤️‍👩 👩‍❤️‍💋‍👨 👩‍❤️‍💋‍👩 👩‍👦 👩‍👦‍👦 👩‍👧 👩‍👧‍👦 👩‍👧‍👧 👩‍👩‍👦 👩‍👩‍👦‍👦 👩‍👩‍👧 👩‍👩‍👧‍👦 👩‍👩‍👧‍👧 👪 👮‍♀️ 👮‍♂️ 👯‍♀️ 👯‍♂️ 👰 👱‍♀️ 👱‍♂️ 👲 👳‍♀️ 👳‍♂️ 👴 👵 👶 👷‍♀️ 👷‍♂️ 👸 👹 👻 👼 👽 👿 💀 💂‍♀️ 💂‍♂️ 💃 💅 💆‍♀️ 💆‍♂️ 💇‍♀️ 💇‍♂️ 💏 💑 💩 💪 🖐 🖕 🖖 🤐 🤑 🤒 🤔 🤕 🤖 🤗 🤘 🤣 🤤 🤥 🤧 😀 😁 😂 😃 😄 😅 😆 😇 😈 😉 😊 😋 😌 😍 😎 😏 😐 😑 😒 😓 😔 😕 😖 😗 😘 😙 😚 😛 😜 😝 😞 😟 😠 😡 😢 😣 😤 😥 😦 😧 😨 😩 😪 😫 😬 😭 😮 😯 😰 😱 😲 😳 😴 😵 😶 😷 😸 😹 😺 😻 😼 😽 😾 😿 🙀 🙁 🙂 🙃 🙄 🙅‍♀️ 🙅‍♂️ 🙆‍♀️ 🙆‍♂️ 🙇‍♀️ 🙇‍♂️ 🙋‍♀️ 🙋‍♂️ 🙌 🙍‍♀️ 🙍‍♂️ 🙎‍♀️ 🙎‍♂️ 🙏 🚶‍♀️ 🚶‍♂️
envelope	envelope ✉️ 💌 📧 📨 📩 🧧
equipment	equipment ⚒️ ⚖️ ⚗️ ⚙️ ⚽️ ⚾️ ⛏️ ⛓️ ⛳️ ⛷️ ⛸️ ⛹️‍♀️ ⛹️‍♂️ 🎣 🎱 🎾 🎿 🏀 🏂 🏄‍♀️ 🏄‍♂️ 🏇 🏈 🏉 🏊‍♀️ 🏊‍♂️ 🏋️‍♂️ 🏏 🏐 🏑 🏒 🏓 🏸 🏹 🔧 🔨 🔩 🔬 🔭 🗜 🚣‍♀️ 🚣‍♂️ 🚴‍♀️ 🚴‍♂️ 🚵‍♀️ 🚵‍♂️ 🛠
european	european 🇪🇺 🏤 🏰 💶
event	event 🎃 🎟 🎤 🎪 🎫 🎭
evil	evil 👿 🦹‍♀️ 🦹‍♂️ 🧿 😈 😼
exclamation	exclamation ‼️ ⁉️ ⚠️ ❕ ❗️ ❣️
exhausted	exhausted 💤 😩 😴 😵
exhibition	exhibition 🎟 🎪 🎫 🎭
expression	expression 🙅‍♀️ 🙅‍♂️ 🙆‍♀️ 🙆‍♂️ 🙋‍♀️ 🙋‍♂️ 🙍‍♀️ 🙍‍♂️ 🙎‍♀️ 🙎‍♂️
eye	eye 👀 👁 👁‍🗨 🤣 🥽 😆 😖 😝 😣 😫 🙄
eyes	eyes ☺️ 👀 👓 🕶 🤗 🤣 😁 😂 😄 😅 😆 😇 😊 😋 😌 😑 😔 😖 😙 😝 😞 😣 😤 😩 😫 😳
face	face ☹️ ☺️ 🌬 🎅 🏃‍♀️ 🏃‍♂️ 🐒 🐔 🐗 🐙 🐣 🐤 🐥 🐦 🐧 🐨 🐭 🐮 🐯 🐰 🐱 🐴 🐵 🐶 🐷 🐸 🐹 🐺 🐻 🐼 🐽 👀 👁 👂 👃 👄 👅 👤 👥 👦 👧 👨 👨‍❤️‍👨 👨‍❤️‍💋‍👨 👨‍👦 👨‍👦‍👦 👨‍👧 👨‍👧‍👦 👨‍👧‍👧 👨‍👨‍👦 👨‍👨‍👦‍👦 👨‍👨‍👧 👨‍👨‍👧‍👦 👨‍👨‍👧‍👧 👨‍👩‍👦 👨‍👩‍👦‍👦 👨‍👩‍👧 👨‍👩‍👧‍👦 👨‍👩‍👧‍👧 👩 👩‍❤️‍👨 👩‍❤️‍👩 👩‍❤️‍💋‍👨 👩‍❤️‍💋‍👩 👩‍👦 👩‍👦‍👦 👩‍👧 👩‍👧‍👦 👩‍👧‍👧 👩‍👩‍👦 👩‍👩‍👦‍👦 👩‍👩‍👧 👩‍👩‍👧‍👦 👩‍👩‍👧‍👧 👪 👮‍♂️ 👯‍♀️ 👯‍♂️ 👰 👱‍♀️ 👱‍♂️ 👲 👳‍♀️ 👳‍♂️ 👴 👵 👶 👷‍♀️ 👷‍♂️ 👸 👹 👺 👻 👼 👽 👿 💀 💂‍♀️ 💂‍♂️ 💃 💆‍♀️ 💆‍♂️ 💇‍♀️ 💇‍♂️ 💏 💑 💩 🕵️‍♀️ 🕵️‍♂️ 🗣 🤐 🤑 🤒 🤓 🤔 🤕 🤖 🤗 🤠 🤡 🤢 🤣 🤤 🤥 🤦‍♀️ 🤦‍♂️ 🤧 🤨 🤩 🤫 🤬 🤭 🤯 🥰 🥱 🥳 🥴 🥵 🥶 🥺 🦁 🦄 🧐 🧴 😀 😁 😂 😃 😄 😅 😆 😇 😈 😉 😊 😋 😌 😍 😎 😏 😐 😑 😒 😓 😔 😕 😖 😗 😘 😙 😚 😛 😜 😝 😞 😟 😠 😡 😢 😣 😤 😥 😦 😧 😨 😩 😪 😫 😬 😭 😮 😯 😰 😱 😲 😳 😴 😵 😶 😷 😸 😹 😺 😻 😼 😽 😾 😿 🙀 🙁 🙂 🙃 🙄 🙅‍♀️ 🙅‍♂️ 🙆‍♀️ 🙆‍♂️ 🙇‍♀️ 🙇‍♂️ 🙈 🙉 🙊 🙋‍♀️ 🙋‍♂️ 🙍‍♀️ 🙍‍♂️ 🙎‍♀️ 🙎‍♂️ 🚶‍♀️ 🚶‍♂️
faces	faces 🤓 🤩 🤭 🥰 🥱 🥳 🥴 🥶 🥺
factory	factory 🏭 👨‍🏭 👩‍🏭 🧑‍🏭
fair	fair 🎟 🎠 🎡 🎢 🎫
fairy	fairy 🐉 🐲 🦄 🧚 🧚‍♀️ 🧚‍♂️
faith	faith ⛩️ ⛪️ 📿 🕋 🕌 🕍
family	family 🎯 🎲 👨‍👦 👨‍👦‍👦 👨‍👧 👨‍👧‍👦 👨‍👧‍👧 👨‍👨‍👦 👨‍👨‍👦‍👦 👨‍👨‍👧 👨‍👨‍👧‍👦 👨‍👨‍👧‍👧 👨‍👩‍👦 👨‍👩‍👦‍👦 👨‍👩‍👧 👨‍👩‍👧‍👦 👨‍👩‍👧‍👧 👩‍👦 👩‍👦‍👦 👩‍👧 👩‍👧‍👦 👩‍👧‍👧 👩‍👩‍👦 👩‍👩‍👦‍👦 👩‍👩‍👧 👩‍👩‍👧‍👦 👩‍👩‍👧‍👧 👪
farm	farm 🌾 🐂 🐃 🐄 🐎 🐏 🐐 🐑 🐓 🐔 🐖 🐮 🐰 🐴 🐷 🦃 🚜
fast	fast ⏩ ⏫ ⏬ ⏭️ 🌭 🌮 🍔 🍕 🍟 💨
father	father 👨‍👦 👨‍👦‍👦 👨‍👧 👨‍👧‍👦 👨‍👧‍👧 👨‍👨‍👦 👨‍👨‍👦‍👦 👨‍👨‍👧 👨‍👨‍👧‍👦 👨‍👨‍👧‍👧 👨‍👩‍👦 👨‍👩‍👦‍👦 👨‍👩‍👧 👨‍👩‍👧‍👦 👨‍👩‍👧‍👧 👪
feel	feel ☹️ 😔 😞 🙁
festival	festival 🎁 🎉 🎊 🎎 🥮
file	file 📁 📂 🗃 🗄 🗳
film	film 🎞 🎥 🎬 📽
fire	fire 🔥 🧯 🚒 🚨
first	first ⛑️ 🌓 🌛 🥇 🩹
fish	fish ♓️ 🍣 🍤 🍥 🎣 🐟 🐠 🐡
fist	fist ✊ 👊 🤛 🤜
five	five 🕔 🕠 🖐 5️⃣
flight	flight ✈️ 👨‍✈️ 👩‍✈️ 💺 🚀 🚁 🛩 🛫 🛬 🛰
flower	flower 🌷 🌸 🌹 🌺 🌻 🌼 🎴 💐 💮 🥀
flowers	flowers 🌷 🌹 🌺 🌼 💐 🥀
flu	flu 💉 🤒 🤧 😷
flying	flying ✈️ 👐 💓 💸 💺 🕴 🥏 🦅 🦇 🦋 🚀 🚁 🛩 🛫 🛬 🛰 🛸
food	food ☕️ 🌭 🌮 🌯 🌰 🌶 🌽 🍅 🍆 🍇 🍈 🍉 🍊 🍋 🍌 🍍 🍎 🍏 🍐 🍑 🍒 🍓 🍔 🍕 🍖 🍗 🍘 🍙 🍚 🍛 🍜 🍝 🍞 🍟 🍠 🍡 🍢 🍣 🍤 🍥 🍦 🍧 🍨 🍩 🍪 🍫 🍬 🍭 🍮 🍯 🍰 🍱 🍲 🍳 🍴 🍵 🍶 🍷 🍸 🍹 🍺 🍻 🍽 🍾 🍿 🎂 🥐 🥑 🥒 🥓 🥔 🥕 🥖 🥗 🥘 🥙 🥚 🥜 🥝 🥞 🥬 🥭 🥯 🦐 🧀 🧄 🧅 🧆 🧇 🧈
foods	foods 🥬 🥭 🥯 🧄 🧅 🧆 🧇 🧈
foot	foot 🐾 💂‍♀️ 💂‍♂️ 🦶
forbidden	forbidden ⛔️ 📵 🔞 🚫 🚯 🚱 🚳 🚷
forecast	forecast ☀️ ☁️ ⛅️ ⛈ 🌤 🌥 🌦 🌧
four	four 🍀 👨‍👨‍👦‍👦 👨‍👨‍👧‍👦 👨‍👨‍👧‍👧 👨‍👩‍👦‍👦 👨‍👩‍👧‍👦 👨‍👩‍👧‍👧 👩‍👩‍👦‍👦 👩‍👩‍👧‍👦 👩‍👩‍👧‍👧 🕓 🕟 4️⃣
french	french 🇫🇷 🇬🇫 🇵🇫 🇹🇫
frown	frown ☹️ 👺 👿 😒 😓 😔 😞 😟 😠 😦 😧 🙁 🙍‍♀️ 🙍‍♂️
frowning	frowning ☹️ 😦 😾 🙍‍♀️ 🙍‍♂️
fruit	fruit 🍅 🍇 🍈 🍉 🍊 🍋 🍌 🍍 🍎 🍏 🍐 🍑 🍒 🍓 🥝 🥥 🥭
fruits	fruits 🍇 🍈 🍉 🍊 🍋 🍍 🍎 🍏 🍐 🍑 🍒 🍓 🥝 🥭
frustrated	frustrated 😖 😣 😩 😫
funny	funny 🤣 🤪 😁 😂 😄
furniture	furniture 🪑 🛋 🛌 🛏
game	game ♟️ ♠️ ♣️ ♥️ ♦️ 🀄️ 🃏 🎮 🎯 🎰 🎲 🎳 🎴 👾 🕹 🖲
games	games ♟️ ♠️ ♣️ ♥️ ♦️
gasp	gasp 😦 😮 😯 😱
gay	gay 🏳️‍🌈 👨‍❤️‍👨 👨‍❤️‍💋‍👨 👨‍👨‍👦 👨‍👨‍👦‍👦 👨‍👨‍👧 👨‍👨‍👧‍👦 👨‍👨‍👧‍👧 👩‍❤️‍👨 👩‍❤️‍👩 👩‍❤️‍💋‍👩
gesture	gesture ☝️ ✊ ✋ ✌️ ✍️ 👆 👇 👈 👉 👊 👋 👌 👍 👎 👏 👐 💅 💪 🖐 🖕 🖖 🤏 🤘 🤙 🤟 🙅‍♀️ 🙅‍♂️ 🙆‍♀️ 🙆‍♂️ 🙋‍♀️ 🙋‍♂️ 🙌 🙍‍♀️ 🙍‍♂️ 🙎‍♀️ 🙎‍♂️ 🙏
getting	getting 👰 💅 💇‍♀️ 💉
girl	girl 🏃‍♀️ 👧 👩 👩‍❤️‍👨 👩‍❤️‍👩 👩‍❤️‍💋‍👩 👩‍💻 👰 👱‍♀️ 👸 💁‍♀️ 💃 💆‍♀️ 💇‍♀️ 🧗‍♀️ 🙅‍♀️ 🙆‍♀️ 🙇‍♀️ 🙋‍♀️ 🙍‍♀️ 🙎‍♀️ 🚶‍♀️
glass	glass 🍷 🍸 🍹 🍺 🥃 🥛
glasses	glasses 🍻 👓 🕶 🤓 🥂 😎
globe	globe 🌍 🌎 🌏 🌐
gloomy	gloomy ☹️ 😔 😞 🙁
goblin	goblin 👹 👺 👿 😈
good	good ☀️ ⛅️ 🌤 🌥 👍 👏 🧧 😉
gray	gray ▫️ ◻️ ◽️ ☑️ ⚪️ ⬜️ 🌑 🌚 🐦 👨‍🦳 👩‍🦳 📁 📂 🔘
green	green ☘️ ♻️ ✅ ✳️ ❇️ ❎ 🌱 🌲 🌳 🌿 🍀 🍃 🍏 🍵 🐍 🐛 👗 💚 💹 📗 🤢 🥗 🥝 🥬 🦎 🚛 🛶 🟢 🟩
grinning	grinning ☺️ 🤑 🤓 🤗 🤠 🤣 🤩 😀 😁 😂 😃 😄 😅 😆 😎 😏 😛 😜 😝 😬 😸
hair	hair 🎀 💁‍♀️ 💁‍♂️ 💆‍♀️ 💆‍♂️ 💇‍♀️ 💇‍♂️ 💈
hairdo	hairdo 💁‍♀️ 💁‍♂️ 💇‍♀️ 💇‍♂️
half	half 🌓 🌗 🍠 🥑 🥝 🥥
hand	hand ☝️ ✊ ✋ ✌️ ✍️ 👆 👇 👈 👉 👊 👋 👌 👍 👎 👏 👐 💅 💪 🖐 🖕 🖖 🤏 🤔 🤘 🤙 🤚 🤞 🤦‍♀️ 🤦‍♂️ 🤭 🙋‍♀️ 🙋‍♂️ 🙌 🙏
hands	hands 👏 🤏 🤗 🤙 🤲 🙆‍♀️ 🙆‍♂️ 🙌 🙏
happy	happy ☺️ 🍻 🎭 🤑 🤓 🤗 🤣 🤭 🥰 🥳 🧧 😀 😁 😂 😃 😄 😅 😆 😇 😈 😉 😊 😋 😌 😍 😎 😏 😗 😘 😙 😚 😛 😜 😝 😬 😸 😹 😺 😻 😽 🙂 🙃 🙆‍♀️ 🙆‍♂️ 🙋‍♀️ 🙋‍♂️
hard	hard 🍬 🍺 👷‍♀️ 👷‍♂️ 🦻 🧏‍♀️ 🧏‍♂️ 😓
hat	hat ⛑️ 🎓 🎩 👒 👲 👳‍♀️ 👳‍♂️ 🕵️‍♀️ 🕵️‍♂️ 🧢
hats	hats 🎩 🕵️‍♀️ 🕵️‍♂️ 🧢
head	head 👤 👥 👦 👧 👨 👩 👱‍♀️ 👱‍♂️ 👴 👵 👶 💆‍♀️ 💆‍♂️ 🗣 🤕 🤖 🤯 🧄 😸 😹 😺 😻 😼 😽 😾 😿 🙀
heart	heart ♥️ ❣️ ❤️ 🏩 👨‍❤️‍👨 👨‍❤️‍💋‍👨 👩‍❤️‍👨 👩‍❤️‍💋‍👨 👩‍❤️‍💋‍👩 💌 💏 💑 💒 💓 💔 💕 💖 💗 💘 💙 💚 💛 💜 💝 💞 💟 🖤 🤍 🤎 🥰 🧡 😍 😘 😻
hearts	hearts ♥️ ❣️ ❤️ 🏩 👨‍❤️‍👨 👨‍❤️‍💋‍👨 👩‍❤️‍👨 👩‍❤️‍💋‍👨 👩‍❤️‍💋‍👩 💌 💏 💑 💒 💓 💔 💕 💖 💗 💘 💙 💚 💛 💜 💝 💞 💟 🖤 🤍 🤎 🥰 🧡 😍 😘 😻
hehe	hehe 🤣 🤭 😂 😉 😜 🙃
high	high ⚡️ ✋ 🎩 🏫 👠 🔆 🔊 🖐 🤒 🦺 🙌 🙏 🚄 🚅 🚆 🚇 🚈 🚉 🚊 🚝
holiday	holiday 🎁 🎃 🎄 🎅 🎉 🎊 🎎
home	home 🏚 🏠 🏡 📹
hooray	hooray 🎉 🥳 😀 😁 😃 😄
horse	horse 🎠 🏇 🐎 🐴
hot	hot ☕️ ♨️ 🌭 🌶 🍙 🍜 🍲 🍵 🔥 🥵
house	house 🏘 🏚 🏠 🏡 🧹 🧺 🧼 🧽 🚽 🚿 🛁
hurrah	hurrah 🥳 😀 😁 😃 😄
hurt	hurt ☹️ 🤒 🤕 😔 😞 😭 🙁
i	i ☺️ 👀 👁‍🗨 🤔 🤞 🤟 🤷‍♀️ 🤷‍♂️ 🥰 🥺 😉 😍 😘 😱 😵 😻 🙂 🙌 🙏 ℹ️
ice	ice ⛸️ ❄️ 🍦 🍨 🏒 🥶 🧊
in	in 🎗 👨‍❤️‍💋‍👨 👩‍❤️‍💋‍👨 👩‍❤️‍💋‍👩 💏 📥 📲 🥰 😁 😄 😍 😒 😘 😻 🙂 🛌
index	index ☝️ 👆 📇 🤞
information	information 💁 💁‍♀️ 💁‍♂️ ℹ️
input	input 🔠 🔡 🔢 🔣 🔤 ℹ️
insect	insect 🐜 🐞 🕷 🦟
insects	insects 🐜 🐞 🕷 🦟
instrument	instrument 🎷 🎸 🎹 🎺 🎻 📯 🥁 🪕
japan	japan 🇯🇵 🏯 💴 🗾
japanese	japanese 🇯🇵 🎎 🏣 🏯 🐕 👹 👺 💴 🔰 🗾 🈁 🈂️ 🈹 🉑 🈴 🈺 🉐 🈯️ 🈷️ 🈶 🈵 🈚️ 🈸 ㊗️ 🈲 ㊙️ 🈳
job	job 👨‍⚕️ 👨‍⚖️ 👨‍✈️ 👨‍🌾 👨‍🍳 👨‍🎤 👨‍🎨 👨‍🏫 👨‍🏭 👨‍💻 👨‍💼 👨‍🔧 👨‍🔬 👨‍🚀 👨‍🚒 👩‍⚕️ 👩‍⚖️ 👩‍✈️ 👩‍🌾 👩‍🍳 👩‍🎤 👩‍🎨 👩‍🏫 👩‍🏭 👩‍💻 👩‍💼 👩‍🔧 👩‍🔬 👩‍🚀 👩‍🚒
jobs	jobs 👨‍💻 👨‍💼 👨‍🔬 👩‍💻 👩‍💼 👩‍🔬
journey	journey 🏍 🚌 🚎 🚕 🚗 🚙
joyful	joyful 😀 😁 😃 😄
junk	junk 🌭 🌮 🍔 🍕 🍟
keycap	keycap *️⃣ 🔟 0️⃣ 1️⃣ 2️⃣ 3️⃣ 4️⃣ 5️⃣ 6️⃣ 7️⃣ 8️⃣ 9️⃣
kid	kid 👨‍👦 👨‍👧 👩‍👦 👩‍👧 🧒
kids	kids 👨‍👦‍👦 👨‍👧‍👦 👨‍👧‍👧 👨‍👨‍👦 👨‍👨‍👦‍👦 👨‍👨‍👧 👨‍👨‍👧‍👦 👨‍👨‍👧‍👧 👨‍👩‍👦 👨‍👩‍👦‍👦 👨‍👩‍👧 👨‍👩‍👧‍👦 👨‍👩‍👧‍👧 👩‍👦‍👦 👩‍👧‍👦 👩‍👧‍👧 👩‍👩‍👦 👩‍👩‍👦‍👦 👩‍👩‍👧 👩‍👩‍👧‍👦 👩‍👩‍👧‍👧 👪
kiss	kiss 💋 😗 😘 😙 😚 😽
kissing	kissing 👨‍❤️‍💋‍👨 👩‍❤️‍💋‍👨 👩‍❤️‍💋‍👩 💏 😗 😘 😙 😚 😽
kissy	kissy 😗 😘 😙 😚
lab	lab 👨‍🔬 👩‍🔬 🔬 🥼 🧪 🧫
laboratory	laboratory 🔬 🥼 🧪 🧫
lake	lake ⛴️ ⛵️ 🐙 🐟 🐠 🐡 🦀 🚤 🛥 🛳
laptop	laptop 🎒 👨‍💻 👩‍💻 💻 💼
large	large ⚪️ ⚫️ ⬛️ ⬜️ 🔘 🔴 🔵 🔶 🔷
laughing	laughing 🤣 🤭 😂 😝 😹 🙊
left	left ↔️ ↩️ ↪️ ⏪ ⏮️ ◀️ ⬅️ 👈 🔍 🔙 🔚 🔛 🖊 🖋 🤛 🛅
lesbian	lesbian 👩‍❤️‍👨 👩‍❤️‍👩 👩‍❤️‍💋‍👩 👩‍👩‍👦 👩‍👩‍👦‍👦 👩‍👩‍👧 👩‍👩‍👧‍👦 👩‍👩‍👧‍👧
letters	letters ✉️ 💌 📧 📨 📩 📪 📫 📬 📭 📮 🔠 🔡 🔤
lift	lift 🏋️‍♀️ 🏋️‍♂️ 🚠 🚡
light	light 🌦 🎽 🏮 🏻 💡 🔦 🕯 🥴 🚄 🚅 🚆 🚇 🚈 🚉 🚊 🚝 🚨 🛩
little	little 👦 👧 👸 👼 👽
lock	lock 🔏 🔐 🔑 🔒 🔓 🗝
lol	lol 🤣 😂 😝 😹
lonely	lonely ☹️ 😔 😞 😩 😭 🙁
long	long ☹️ 🤥 😔 😞 🙁
love	love ❣️ ❤️ 🏩 👨‍❤️‍👨 👨‍❤️‍💋‍👨 👩‍❤️‍👨 👩‍❤️‍👩 👩‍❤️‍💋‍👨 👩‍❤️‍💋‍👩 💌 💏 💑 💒 💓 💔 💕 💖 💗 💘 💙 💚 💛 💜 💝 💞 💟 🖤 🤟 🥰 🧡 😍 😘 😻
lovebirds	lovebirds 👨‍❤️‍👨 👨‍❤️‍💋‍👨 👩‍❤️‍👨 👩‍❤️‍👩 👩‍❤️‍💋‍👨 👩‍❤️‍💋‍👩 💏 💑
loving	loving 👨‍❤️‍👨 👨‍❤️‍💋‍👨 👩‍❤️‍👨 👩‍❤️‍👩 👩‍❤️‍💋‍👨 👩‍❤️‍💋‍👩 💏 💑 🥰 😍 😘 😻 😽
luggage	luggage 🏷 🧳 🛄 🛅
lunch	lunch 🌭 🌮 🌯 🍔 🍕 🍛 🍜 🍝 🍱 🍲 🍴 🍽 👝 🥗 🥘 🥙
magnifying	magnifying 🔍 🔎 🕵️‍♀️ 🕵️‍♂️
mail	mail ✉️ 💌 📦 📧 📨 📩 📪 📫 📬 📭 📮
mailbox	mailbox 📪 📫 📬 📭 📮
mammal	mammal 🦘 🦙 🦛 🦝 🦡 🦥 🦦 🦧 🦨
mammals	mammals 🦘 🦙 🦛 🦝 🦡 🦥 🦦 🦧 🦨
man	man ⛹️‍♂️ 🌚 🌝 🏃‍♂️ 🏄‍♂️ 🏊‍♂️ 🏋️‍♂️ 🏌️‍♂️ 👞 👨 👨‍⚕️ 👨‍⚖️ 👨‍✈️ 👨‍❤️‍👨 👨‍❤️‍💋‍👨 👨‍🌾 👨‍🍳 👨‍🎓 👨‍🎤 👨‍🎨 👨‍🏫 👨‍🏭 👨‍💻 👨‍💼 👨‍🔧 👨‍🔬 👨‍🦯 👨‍🦰 👨‍🦱 👨‍🦲 👨‍🦳 👨‍🦼 👨‍🦽 👨‍🚀 👨‍🚒 👩‍❤️‍👨 👩‍❤️‍💋‍👨 👫 👱 👱‍♂️ 👲 👳‍♂️ 👴 👷‍♂️ 💁‍♂️ 💆‍♂️ 💇‍♂️ 💏 💑 🕳 🕴 🕵️‍♂️ 🕺 🤦‍♂️ 🤴 🤵 🤷‍♂️ 🤸‍♂️ 🤹‍♂️ 🤽‍♂️ 🤾‍♂️ 🦸‍♂️ 🦹‍♂️ 🧍‍♂️ 🧎‍♂️ 🧏‍♂️ 🧖‍♂️ 🧗‍♂️ 🧘‍♂️ 🧙‍♂️ 🧚‍♂️ 🧛‍♂️ 🧝‍♂️ 🧞‍♂️ 🧟‍♂️ 🙅‍♂️ 🙆‍♂️ 🙇‍♂️ 🙋‍♂️ 🙍‍♂️ 🙎‍♂️ 🚣‍♂️ 🚴‍♂️ 🚵‍♂️ 🚶‍♂️
master	master 🔏 🔐 🔒 🔓
math	math ♾️ ✖️ ➕ ➖ ➗
meal	meal 🌭 🌮 🌯 🍔 🍛 🍜 🍝 🍱 🍲 🍴 🍽 🥗 🥘
meat	meat 🍔 🍖 🍗 🍤 🥓 🥩
mechanic	mechanic 👨‍🔧 👩‍🔧 🧑‍🔧 🧰
medal	medal 🎖 🏅 🥇 🥈 🥉
medals	medals 🎖 🏅 🥇 🥈 🥉
medical	medical 🏥 🩺 😷 🚑 🚒
meditating	meditating 🧎‍♀️ 🧎‍♂️ 🧘‍♀️ 🧘‍♂️
medium	medium ◻️ ◼️ ◽️ ◾️ ⚪️ ⚫️ 🏽 🔉
men	men 👕 👨‍❤️‍👨 👨‍❤️‍💋‍👨 👨‍💻 👨‍💼 👨‍🔬 👨‍🤝‍👨 👨‍🦯 👨‍🦱 👨‍🦲 👨‍🦳 👨‍🦼 👨‍🦽 👯‍♂️ 💁‍♂️ 🕵️‍♂️ 🤼‍♂️ 🧍‍♂️ 🧎‍♂️ 🧏‍♂️ 🧖‍♂️ 🧗‍♂️ 🚹 🚻
meow	meow 🐱 😸 😺 😻
metro	metro 🚆 🚇 🚈 🚉 🚊 Ⓜ️
miserable	miserable ☹️ 😖 😩 😭
mom	mom 👨‍👩‍👦 👨‍👩‍👦‍👦 👨‍👩‍👧 👨‍👩‍👧‍👦 👨‍👩‍👧‍👧 👩‍👦 👩‍👦‍👦 👩‍👧 👩‍👧‍👦 👩‍👧‍👧 👩‍👩‍👦 👩‍👩‍👦‍👦 👩‍👩‍👧 👩‍👩‍👧‍👦 👩‍👩‍👧‍👧 👪
money	money 💰 💲 💴 💵 💶 💸 🤑 🧧
monkey	monkey 🐒 🐵 🦍 🙈 🙉 🙊
monorail	monorail 🚄 🚅 🚆 🚇 🚈 🚉 🚊 🚝
moon	moon ⛺️ 🌑 🌒 🌓 🌔 🌕 🌖 🌗 🌘 🌙 🌚 🌛 🌜 🌝 🎑 🥮
mother	mother 🌬 👨‍👩‍👦 👨‍👩‍👦‍👦 👨‍👩‍👧 👨‍👩‍👧‍👦 👨‍👩‍👧‍👧 👩‍👦 👩‍👦‍👦 👩‍👧 👩‍👧‍👦 👩‍👧‍👧 👩‍👩‍👦 👩‍👩‍👦‍👦 👩‍👩‍👧 👩‍👩‍👧‍👦 👩‍👩‍👧‍👧 👪 🤬
mountain	mountain ⛰️ 🌁 🌄 🌋 🏔 🏞 🗻 🧗‍♀️ 🧗‍♂️ 🚞 🚠 🚵 🚵‍♀️ 🚵‍♂️
mouse	mouse 🐁 🐭 🕹 🖱 🖲
movie	movie 🍿 🎞 🎥 🎦 🎫 🎬 📼 📽
music	music 🎤 🎧 🎵 🎶 🎷 🎸 🎹 🎺 🎻 🎼 👨‍🎤 👩‍🎤 🥁 🪕
musical	musical 🎧 🎭 🎵 🎶 🎷 🎸 🎹 🎺 🎻 🎼 👨‍🎤 👩‍🎤 🥁
my	my ⌚️ 💁‍♀️ 💁‍♂️ 📱 🤗 😇 😍
nature	nature ☀️ ☁️ ☂️ ☃️ ☄️ ☔️ ☘️ ⚡️ ⛄️ ⛅️ ⛈️ ⛰️ ❄️ ⭐️ 🌁 🌄 🌅 🌈 🌊 🌋 🌌 🌍 🌏 🌑 🌒 🌓 🌔 🌕 🌖 🌗 🌘 🌙 🌚 🌛 🌜 🌝 🌞 🌟 🌠 🌤 🌥 🌦 🌧 🌨 🌩 🌪 🌫 🌬 🌰 🌱 🌲 🌳 🌴 🌵 🌶 🌷 🌸 🌹 🌺 🌻 🌼 🌽 🌾 🌿 🍀 🍁 🍂 🍃 🍄 🍅 🍆 🍇 🍈 🍉 🍊 🍋 🍌 🍍 🍎 🍏 🍐 🍑 🍒 🍓 🍖 🍗 🍞 🍠 🍤 🍯 🎄 🎆 🎇 🎋 🎍 🏔 🏜 🏝 🏞 🐚 💐 💦 💧 💨 💫 🔥 🕸 🗻 🧀
nautical	nautical ⚓️ ⛴️ ⛵️ 🚢 🚤 🛥 🛳
nervous	nervous 😟 😥 😬 😰
new	new 🇳🇨 🇳🇿 🌑 🌚 🌵 🎉 🎊 🗽 🆕
night	night ⛺️ 🌃 🌉 🌌 🌑 🌒 🌓 🌔 🌕 🌖 🌗 🌘 🌙 🌚 🌛 🌜 🌝 🌠 🎆 🎇
no	no ⛔️ 👎 👨‍🦲 👩‍🦲 📵 🔞 😉 😎 😐 😑 😶 🙅‍♀️ 🙅‍♂️ 🚭 🚮 🚯 🚳 🚷 🆖 🈵
non-binary	non-binary 👮 👷 💂 🕵 🧑‍⚕️ 🧑‍⚖️ 🧑‍✈️ 🧑‍🌾 🧑‍🍳 🧑‍🎓 🧑‍🎤 🧑‍🎨 🧑‍🏫 🧑‍🏭 🧑‍💻 🧑‍💼 🧑‍🔧 🧑‍🔬 🧑‍🚀 🧑‍🚒 🧗 🧙 🧚 🧛 🧝 🧞 🧟
not	not ⛔️ 👎 📵 🔞 🤒 🤔 🤧 😑 😒 🙅‍♀️ 🙅‍♂️ 🙉 🚫 🚯 🚱 🚳 🚷 🈶
notebook	notebook 💻 📒 📓 📔 📕 📗 📘 📙
notes	notes 🎵 🎶 📝 🗒
occupation	occupation 👨‍⚕️ 👨‍⚖️ 👨‍✈️ 👨‍🌾 👨‍🍳 👨‍🎤 👨‍🎨 👨‍🏫 👨‍🏭 👨‍💻 👨‍💼 👨‍🔧 👨‍🔬 👨‍🚀 👨‍🚒 👩‍⚕️ 👩‍⚖️ 👩‍✈️ 👩‍🌾 👩‍🍳 👩‍🎤 👩‍🎨 👩‍🏫 👩‍🏭 👩‍💻 👩‍💼 👩‍🔧 👩‍🔬 👩‍🚀 👩‍🚒
occupations	occupations 👨‍💻 👨‍💼 👨‍🔬 👩‍💻 👩‍💼 👩‍🔬
ocean	ocean ⚓️ ⛴️ ⛵️ 🌅 🌊 🏖 🏝 🐋 🐙 🐚 🐟 🐠 🐡 🐬 🐳 🦀 🦈 🦑 🚢 🚤 🛥 🛳
office	office 🏢 👨‍💼 👩‍💼 💼 🧑‍💼
oh	oh 🤦‍♀️ 🤦‍♂️ 😔 😧 😨 😬 😱 🙄 🙈 🙉 🙊
ok	ok 👌 👍 🙆‍♀️ 🙆‍♂️ 🆗
okay	okay 👌 🙆‍♀️ 🙆‍♂️ 🆗
old	old ☎️ ✒️ 🎅 🏚 👴 👵 📜 📞 📟 📠 📺 📻 🖋 🗝
omg	omg 🤯 😮 😯 😱 😲 😳
on	on ⛷ 🏂 👀 🔛 🚩
oncoming	oncoming 🚆 🚇 🚉 🚊 🚍 🚔 🚖 🚘
one	one 🐪 👨‍👦 👨‍👧 👨‍👨‍👦 👨‍👨‍👧 👨‍👩‍👦 👨‍👩‍👧 👩‍👦 👩‍👧 👩‍👩‍👦 👩‍👩‍👧 👪 💯 🕐 🕜 😉 😘 😜 😢 1️⃣
oof	oof 😅 😓 😣 😥 😰
open	open 🎤 👐 📂 📖 📬 📭 🔓 🗃 🤣 🤲 😀 😂 😃 😄 😅 😆 😍 😵 🈺
orange	orange ✴️ 🍊 🍲 📙 🔶 🔸 🥕 🧡 🟠 🟧 🆚
outdoor	outdoor ⚽️ ⚾️ ⛳️ ⛷️ ⛸️ ⛹️‍♀️ ⛹️‍♂️ 🎣 🎱 🎾 🎿 🏀 🏂 🏄‍♀️ 🏄‍♂️ 🏇 🏈 🏉 🏊‍♀️ 🏊‍♂️ 🏋️‍♂️ 🏌️‍♀️ 🏌️‍♂️ 🏏 🏐 🏑 🏒 🏓 🏸 🏹 🧗‍♀️ 🧗‍♂️ 🚣‍♀️ 🚣‍♂️ 🚴‍♀️ 🚴‍♂️ 🚵‍♀️ 🚵‍♂️
paddle	paddle 🏓 🏸 🚣‍♀️ 🚣‍♂️
page	page 📃 📄 📈 📉 📊 📑 📜
palm	palm ✋ 🌴 🏝 🖐
paper	paper 🏮 👝 👨‍💼 👩‍💼 📃 📄 📆 📈 📉 📊 📎 📑 📜 📝 🔖 🗺 🧻
parent	parent 👨‍👦 👨‍👧 👩‍👦 👩‍👧
parents	parents 👨‍👦‍👦 👨‍👧‍👦 👨‍👧‍👧 👨‍👨‍👦 👨‍👨‍👦‍👦 👨‍👨‍👧 👨‍👨‍👧‍👦 👨‍👨‍👧‍👧 👨‍👩‍👦 👨‍👩‍👦‍👦 👨‍👩‍👧 👨‍👩‍👧‍👦 👨‍👩‍👧‍👧 👩‍👦‍👦 👩‍👧‍👦 👩‍👧‍👧 👩‍👩‍👦 👩‍👩‍👦‍👦 👩‍👩‍👧 👩‍👩‍👧‍👦 👩‍👩‍👧‍👧 👪
park	park 🎟 🎪 🎫 🏞
parties	parties 🎈 🎉 🎊 🥳
partly	partly ⛅️ 🌤 🌥 🌦
party	party 🎁 🎈 🎉 🎊 🥳
pen	pen ✍️ ✒️ 🔏 🖊 🖋
people	people 👨‍❤️‍💋‍👨 👨‍💻 👨‍💼 👨‍🔬 👩‍❤️‍💋‍👨 👩‍❤️‍💋‍👩 👩‍💻 👩‍💼 👩‍🔬 💁‍♀️ 💁‍♂️ 💏 🤨 🤼 🧍‍♀️ 🧍‍♂️ 🧎‍♀️ 🧎‍♂️ 🧏‍♀️ 🧏‍♂️ 🧑‍🤝‍🧑 🧖‍♀️ 🧖‍♂️ 🧗‍♀️ 🧗‍♂️
person	person ☝️ ⛷️ ⛹️ ⛹️‍♀️ ⛹️‍♂️ ✊ ✋ ✌️ ✍️ 🎅 🏂 🏃 🏃‍♀️ 🏃‍♂️ 🏄 🏄‍♀️ 🏄‍♂️ 🏇 🏊 🏊‍♀️ 🏊‍♂️ 🏋 🏋️‍♀️ 🏋️‍♂️ 🏌 🏌️‍♀️ 👀 👁 👂 👃 👄 👅 👆 👇 👈 👉 👊 👋 👌 👍 👎 👏 👐 👣 👤 👥 👦 👧 👨 👨‍⚕️ 👨‍⚖️ 👨‍✈️ 👨‍❤️‍👨 👨‍❤️‍💋‍👨 👨‍🌾 👨‍🍳 👨‍🎓 👨‍🎤 👨‍🏫 👨‍🏭 👨‍👦 👨‍👦‍👦 👨‍👧 👨‍👧‍👦 👨‍👧‍👧 👨‍👨‍👦 👨‍👨‍👦‍👦 👨‍👨‍👧 👨‍👨‍👧‍👦 👨‍👨‍👧‍👧 👨‍👩‍👦 👨‍👩‍👦‍👦 👨‍👩‍👧 👨‍👩‍👧‍👦 👨‍👩‍👧‍👧 👨‍💻 👨‍💼 👨‍🔬 👨‍🦱 👨‍🦲 👨‍🦳 👨‍🚀 👨‍🚒 👩 👩‍⚕️ 👩‍⚖️ 👩‍✈️ 👩‍❤️‍👨 👩‍❤️‍👩 👩‍❤️‍💋‍👨 👩‍❤️‍💋‍👩 👩‍🌾 👩‍🍳 👩‍🎓 👩‍🎤 👩‍🏫 👩‍🏭 👩‍👦 👩‍👦‍👦 👩‍👧 👩‍👧‍👦 👩‍👧‍👧 👩‍👩‍👦 👩‍👩‍👦‍👦 👩‍👩‍👧 👩‍👩‍👧‍👦 👩‍👩‍👧‍👧 👩‍💻 👩‍💼 👩‍🔬 👩‍🦰 👩‍🦱 👩‍🦲 👩‍🦳 👩‍🚀 👩‍🚒 👪 👮‍♀️ 👮‍♂️ 👯‍♀️ 👯‍♂️ 👰 👱 👱‍♀️ 👱‍♂️ 👲 👳 👳‍♀️ 👳‍♂️ 👴 👵 👶 👷‍♀️ 👷‍♂️ 👸 👼 💁‍♀️ 💁‍♂️ 💂‍♀️ 💂‍♂️ 💃 💅 💆 💆‍♀️ 💆‍♂️ 💇 💇‍♀️ 💇‍♂️ 💏 💑 💪 🕴 🕵️‍♀️ 🕵️‍♂️ 🖐 🖕 🖖 🗣 🤘 🤦 🤦‍♀️ 🤦‍♂️ 🤵 🤷 🤷‍♀️ 🤷‍♂️ 🤸 🤹 🤽 🤾 🧍 🧍‍♀️ 🧍‍♂️ 🧎 🧎‍♀️ 🧎‍♂️ 🧏‍♀️ 🧏‍♂️ 🧑‍🦯 🧑‍🦰 🧑‍🦱 🧑‍🦲 🧑‍🦳 🧑‍🦼 🧑‍🦽 🧖 🧖‍♀️ 🧖‍♂️ 🧗‍♀️ 🧗‍♂️ 🧘 🙅 🙅‍♀️ 🙅‍♂️ 🙆 🙆‍♀️ 🙆‍♂️ 🙇 🙇‍♀️ 🙇‍♂️ 🙋 🙋‍♀️ 🙋‍♂️ 🙌 🙍 🙍‍♀️ 🙍‍♂️ 🙎 🙎‍♀️ 🙎‍♂️ 🙏 🚣 🚣‍♀️ 🚣‍♂️ 🚴 🚴‍♀️ 🚴‍♂️ 🚵 🚵‍♀️ 🚵‍♂️ 🚶 🚶‍♀️ 🚶‍♂️ 🛀 🛌
pet	pet 🐰 🐱 🐶 🐹
phone	phone ☎️ 📞 📱 📲 📳 📴
phones	phones ☎️ 📞 📱 📲 📴
picture	picture 🌁 🌃 🌄 🌅 🌆 🌇 🌈 🌉 🌌 🌠 🎆 🎇 🎑 🏙 🏭 🖼 🗾 🛣 🛤
pig	pig 🐖 🐗 🐷 🐽
pink	pink 🌷 🌸 🌺 🎀 👙 👚 👛 💄 💓 💕 💖 💗 💘 💝 💞 💟
plane	plane ✈️ 🛩 🛫 🛬
planet	planet 🌍 🌎 🌏 🪐
plant	plant ☘️ 🌰 🌱 🌲 🌳 🌴 🌵 🌷 🌸 🌹 🌺 🌻 🌼 🌾 🌿 🍀 🍁 🍂 🍃 🍄 🎄 🎋 🎍 💐
play	play ⏯ ▶️ ◀️ 🎭
playing	playing ♠️ ♣️ ♥️ ♦️ 🃏 🎴 🤽‍♀️ 🤽‍♂️ 🤾‍♀️ 🤾‍♂️
pleased	pleased 😀 😁 😃 😄
point	point 👆 👇 👈 👉 📷 📸
pointing	pointing ☝️ 👆 👇 👈 👉 🖐 🖕
points	points 👆 👇 👈 👉
police	police 👮 👮‍♀️ 👮‍♂️ 🚓 🚔 🚨
post	post 🌁 🌃 🌄 🌅 🌆 🌇 🌉 🌌 🌠 🎆 🎑 🏙 🏣 🏤 🏭 🗾 🚢 🛣 🛤
postal	postal ✉️ 💌 📧 📨 📩 📪 📫 📬 📭 📮 📯
pouting	pouting 😡 😾 🙍‍♀️ 🙍‍♂️ 🙎‍♀️ 🙎‍♂️
profession	profession 👨‍⚕️ 👨‍⚖️ 👨‍✈️ 👨‍🌾 👨‍🍳 👨‍🎤 👨‍🎨 👨‍🏫 👨‍🏭 👨‍💻 👨‍💼 👨‍🔧 👨‍🔬 👨‍🚀 👨‍🚒 👩‍⚕️ 👩‍⚖️ 👩‍✈️ 👩‍🌾 👩‍🍳 👩‍🎤 👩‍🎨 👩‍🏫 👩‍🏭 👩‍💻 👩‍💼 👩‍🔧 👩‍🔬 👩‍🚀 👩‍🚒 🕵️‍♀️ 🕵️‍♂️
professions	professions 👨‍💻 👨‍💼 👨‍🔬 👩‍💻 👩‍💼 👩‍🔬
prohibited	prohibited ⛔️ 📵 🔞 🚫 🚯 🚱 🚳 🚷 🈲
punch	punch 👊 🤛 🤜 🥊
punctuation	punctuation ‼️ ⁉️ ❓ ❔ ❕ ❗️ ❣️
purple	purple ☂️ ☔️ ☦️ ☪️ ☮️ ☯️ ☸️ ♈️ ♉️ ♊️ ♋️ ♌️ ♍️ ♎️ ♏️ ♐️ ♑️ ♒️ ♓️ ⚛️ ⛎ ✝️ ✡️ 🍇 👾 💜 💟 🔯 🕉 🕎 🛐 🟣 🟪 🆔
racing	racing 🏁 🏇 🏍 🏎
rail	rail 🚃 🚄 🚅 🚈 🚋 🚝 🚟 🛤
railroad	railroad 🚃 🚆 🚞 🛤
raise	raise 🖐 🙋‍♀️ 🙋‍♂️ 🙌
raised	raised ✊ ✋ 📫 🖐 🤚 🤨 🙋‍♀️ 🙋‍♂️ 🙌
raising	raising 🙆‍♀️ 🙆‍♂️ 🙋‍♀️ 🙋‍♂️
rapid	rapid 🚄 🚅 🚆 🚇 🚈 🚉 🚊 🚝
reading	reading 🎼 👓 📖 📚 🤓
recreation	recreation ⛱️ ⛴️ ⛵️ 🎯 🎰 🎳 🏁 🏍 🏖 💺 🤿 🪂 🚙 🚢 🚤 🚲 🛥 🛳
red	red ‼️ ⁉️ ♥️ ♦️ ❓ ❗️ ❣️ ❤️ 🌂 🌶 🌹 🍎 🍷 🎈 🎒 🏥 👨‍🦰 👩‍🦰 💄 💔 📌 📍 📕 📮 🔴 🔺 🔻 🖍 🤬 🥀 🥊 🥵 🦞 🦰 🧧 😡 🚗 🚘 🚨 🚩 🛑 🟥
relieved	relieved 😅 😌 😥 😪
religion	religion ☦️ ☪️ ☮️ ☯️ ☸️ ⛩️ ⛪️ ✝️ ✡️ 📿 🔯 🕉 🕋 🕌 🕍 🕎 🙏 🛐 🛕
rice	rice 🌾 🍘 🍙 🍚 🍛 🍶
ride	ride 🎟 🎠 🎡 🎢
right	right ↩️ ↪️ ⏩ ⏭️ ▶️ ✒️ ➡️ ⤴️ ⤵️ 👉 🔎 🔛 🔜 🤜
road	road 🏍 🚗 🚙 🚴‍♀️ 🚴‍♂️ 🛣
rock	rock 🎸 🤘 🧗 🧗‍♀️ 🧗‍♂️
running	running 🎽 🏃‍♀️ 🏃‍♂️ 🐎 👟 💨
sad	sad ☹️ 🤒 🤕 🤥 🤧 😐 😑 😔 😕 😞 😟 😢 😦 😧 😨 😩 😫 😭 😿 🙁 🙍‍♀️ 🙍‍♂️
safari	safari 🐅 🐆 🐊 🐯 🦁 🦏
safety	safety ☢️ ☣️ ⛑️ 🥽 🦺 🧷
saint	saint 🇧🇱 🇰🇳 🇱🇨 🇵🇲 🇸🇭 🇻🇨 🎅
scared	scared 😟 😦 😧 😨 😱 😳 🙀
scary	scary 🎃 👹 👺 👿 😈
scene	scene 🌁 🌃 🌄 🌅 🌆 🌇 🌈 🌉 🌋 🌌 🌠 🎆 🎇 🎑 🎡 🏗 🏙 🏭 🗾 🚞 🚢 🛣 🛤
school	school 🎒 🎓 🏫 🚌
science	science ⚗️ 🔬 🔭 🥼 🧪 🧫 🧬
scientist	scientist 👨‍🔬 👩‍🔬 🥼 🧑‍🔬
sea	sea ⚓️ ⛴️ ⛵️ 🌅 🌊 🐋 🐙 🐚 🐟 🐠 🐡 🐬 🐳 🦀 🦈 🦑 🦦 🧂 🚢 🚤 🛥 🛳
security	security 👮‍♂️ 🚓 🚔 🚨
seriously	seriously 😐 😑 😒 😳
setting	setting 🌁 🌃 🌄 🌅 🌆 🌇 🌈 🌉 🌋 🌌 🌠 🎆 🎇 🎑 🏘 🏙 🏭 🗾 🛣 🛤
shape	shape ▪️ ▫️ ◻️ ◼️ ◽️ ◾️ ⚪️ ⚫️ ⬛️ ⬜️ 🔘 🔲 🔳 🔴 🔵 🔶 🔷 🔸 🔹 🔺 🔻
ship	ship ⚓️ ⛴ 🚢 🛳
shirt	shirt 🎽 👔 👕 👚
shocked	shocked 🤯 😨 😮 😯 😱 😲 😳 🙀 🙊
shoe	shoe ⛸️ 👞 👟 👠 👡 👢 🥾 🥿
shoes	shoes 👞 👟 🥾 🥿 🩰
show	show 🎟 🎤 🎪 🎫 🎭
shower	shower 🧼 🧽 🚿 🛀
sick	sick 🤒 🤕 🤢 🤧 🤮 😷
sign	sign ‼️ ⁉️ *️⃣ #️⃣ 〽️ © ® ↔️ ↕️ ↖️ ↗️ ↘️ ↙️ ↩️ ↪️ ⏩ ⏪ ⏫ ⏬ ⏭️ ⏮️ ⏯️ ⏸️ ⏹️ ⏺️ ▶️ ◀️ ☢️ ☣️ ☦️ ☪️ ☮️ ☯️ ☸️ ♈️ ♉️ ♊️ ♋️ ♌️ ♍️ ♎️ ♏️ ♐️ ♑️ ♒️ ♓️ ♨️ ♻️ ♿️ ⚛️ ⚜️ ⚠️ ⛎ ⛔️ ✅ ✔️ ✖️ ✝️ ✡️ ✳️ ✴️ ❇️ ❌ ❎ ❓ ❔ ❕ ❗️ ➕ ➖ ➗ ➡️ ➰ ➿ ⤴️ ⤵️ ⬅️ ⬆️ ⬇️ ⭕️ 🌀 🌐 🎦 🏁 🏧 🏳️‍🌈 💈 💋 💟 💠 💢 💤 💮 💯 💱 💲 💹 📛 📳 📴 📵 📶 🔀 🔁 🔂 🔃 🔄 🔅 🔆 🔙 🔚 🔛 🔜 🔝 🔞 🔟 🔠 🔡 🔢 🔣 🔤 🔯 🔰 🔱 🔼 🔽 🕉 🕎 🤘 🤟 🚏 🚥 🚦 🚧 🚫 🚭 🚮 🚯 🚱 🚳 🚷 🚸 🚹 🚺 🚻 🚼 🚾 🛂 🛃 🛄 🛅 🛐 0️⃣ 1️⃣ 2️⃣ 3️⃣ 4️⃣ 5️⃣ 6️⃣ 7️⃣ 8️⃣ 9️⃣ 🅰️ 🆎 🅱️ 🆑 🆒 🆓 ℹ️ 🆔 Ⓜ️ 🆕 🆖 🅾️ 🆗 🅿️ 🆘 ™️ 🆙 🆚 🈁 🈂️ 🈹 🉑 🈴 🈺 🉐 🈯️ 🈷️ 🈶 🈵 🈚️ 🈸 ㊗️ 🈲 ㊙️ 🈳
silhouette	silhouette 👤 👥 🗣 🗾
silly	silly 🤪 😛 😜 😝 🙃
silver	silver 👨‍🦳 👩‍🦳 💍 🥈
single	single ➰ 🏠 🏡 💧 🔂
six	six 🔯 🕕 🕡 6️⃣
ski	ski ⛷️ 🎿 🚠 🚡
skip	skip ⏩ ⏪ ⏭️ ⏮️
sky	sky ☄️ ✨ ⭐️ 🌃 🌄 🌅 🌆 🌇 🌉 🌌 🌑 🌒 🌓 🌔 🌕 🌖 🌗 🌘 🌙 🌚 🌛 🌜 🌝 🌞 🌟 🌠 🎆 🎇 🏙 💫 🗼 🚟 🚡
skyline	skyline 🌃 🌆 🌇 🌉 🏙
sleeping	sleeping 💤 😴 🚃 🛌 🛏
sleepy	sleepy 💤 🤤 🥱 😑 😪 😴
small	small ▪️ ▫️ ◽️ ◾️ 👝 🔸 🔹 🔺 🔻 😕 🙁 🙂 🛩
smile	smile 💩 🤤 😀 😃 😇 😈 😬
smiley	smiley ☺️ 💩 🤑 🤓 🤗 🤣 🤤 🤩 🤭 🥰 😀 😁 😂 😃 😄 😅 😆 😇 😈 😉 😊 😋 😌 😍 😎 😏 😗 😘 😙 😚 😛 😜 😝 😬 🙂 🙃
smiling	smiling ☺️ 🐒 💩 🤑 🤓 🤗 🤣 🥰 😀 😁 😂 😃 😄 😅 😆 😇 😈 😉 😊 😋 😌 😍 😎 😏 😗 😘 😙 😚 😛 😜 😝 😬 😺 😻 🙂 🙃 🙆‍♀️ 🙆‍♂️
smooch	smooch 💋 😘 😚 😽
snow	snow ☃️ ⛄️ ⛷️ ❄️ 🌨 🍧 🎿 🏂 🏔
so	so 🤣 🥵 😀 😁 😂 😃 😄 😍 😞 😭 😳
son	son 👨‍👦 👨‍👦‍👦 👨‍👨‍👦 👨‍👨‍👦‍👦 👨‍👨‍👧‍👦 👨‍👩‍👦 👨‍👩‍👦‍👦 👨‍👩‍👧 👨‍👩‍👧‍👦 👩‍👦 👩‍👦‍👦 👩‍👧‍👦 👩‍👩‍👦 👩‍👩‍👦‍👦 👩‍👩‍👧‍👦 👪 🤬
sorrowful	sorrowful ☹️ 😔 😞 🙁
sound	sound 🎙 🎼 📢 📣 📻 🔇 🔈 🔉 🔊 🔔 🔕 🚨
south	south 🇬🇸 🇰🇷 🇸🇸 🇿🇦
space	space 👽 👾 🚀 🛰
speaker	speaker 📢 📣 🔇 🔈 🔉 🔊
spiral	spiral 🌀 🐚 📆 🗒 🗓
spooked	spooked 😦 😧 😱 😳
sport	sport ⚽️ ⚾️ ⛳️ ⛷️ ⛸️ ⛹️‍♀️ ⛹️‍♂️ 🎣 🎱 🎳 🎽 🎾 🎿 🏀 🏁 🏂 🏄‍♀️ 🏄‍♂️ 🏅 🏇 🏈 🏉 🏊‍♀️ 🏊‍♂️ 🏋️‍♂️ 🏌️‍♂️ 🏎 🏏 🏐 🏑 🏒 🏓 🏸 🏹 🤺 🤽‍♀️ 🤽‍♂️ 🤾‍♀️ 🤾‍♂️ 🥅 🥊 🥋 🥍 🥎 🚙 🚣‍♀️ 🚣‍♂️ 🚴‍♀️ 🚴‍♂️ 🚵‍♀️ 🚵‍♂️ 🛶
sporting	sporting ⚽️ ⚾️ 🏀 🏈 🏒 🥍 🥎
sports	sports ⚽️ ⚾️ ⛳️ ⛷️ ⛸️ 🎾 🎿 🏀 🏂 🏅 🏇 🏈 🏉 🏎 🏏 🏑 🏒 🏓 🏟 🏸 🏹 🥍 🥎
square	square *️⃣ #️⃣ ↔️ ↕️ ↖️ ↗️ ↘️ ↙️ ↩️ ↪️ ⏩ ⏪ ⏫ ⏬ ⏭️ ⏮️ ⏯️ ⏸️ ⏹️ ⏺️ ▪️ ▫️ ▶️ ◀️ ◻️ ◼️ ◽️ ◾️ ☦️ ☪️ ☮️ ☯️ ☸️ ♈️ ♉️ ♊️ ♋️ ♌️ ♍️ ♎️ ♏️ ♐️ ♑️ ♒️ ♓️ ♿️ ⚛️ ⛎ ✅ ✝️ ✡️ ✳️ ✴️ ❇️ ❎ ➡️ ➿ ⤴️ ⤵️ ⬅️ ⬆️ ⬇️ ⬛️ ⬜️ 🎦 🏧 🏳 🏴 💟 💹 📳 📴 📶 🔀 🔁 🔂 🔄 🔟 🔠 🔡 🔢 🔣 🔤 🔯 🔲 🔳 🔼 🔽 🕉 🕎 🚭 🚮 🚹 🚺 🚻 🚼 🚾 🛂 🛃 🛄 🛅 🛐 🟥 🟦 🟧 🟨 🟩 🟪 🟫 0️⃣ 1️⃣ 2️⃣ 3️⃣ 4️⃣ 5️⃣ 6️⃣ 7️⃣ 8️⃣ 9️⃣ 🅰️ 🆎 🅱️ 🆑 🆒 🆓 ℹ️ 🆔 🆕 🆖 🅾️ 🆗 🅿️ 🆘 🆙 🆚 🈁 🈂️ 🈹 🈴 🈺 🈯️ 🈷️ 🈶 🈵 🈚️ 🈸 🈲 🈳
squares	squares 🟥 🟦 🟧 🟨 🟩 🟪 🟫
standing	standing 🐥 🕴 🧍 🧍‍♀️ 🧍‍♂️
star	star *️⃣ ☪️ 🇺🇸 ✡️ ✨ ✴️ ⭐️ 🌌 🌟 💫 🤩
starch	starch 🍙 🍚 🍝 🍞 🥔
stars	stars 🇺🇸 ✨ ⭐️ 🌌 🌟 🤩
startled	startled 😮 😯 😱 😲
steam	steam 🧖‍♀️ 🧖‍♂️ 😤 🚂
stick	stick 🍡 🍢 🏏 🏑 🏒 🧈
sticking	sticking 🤑 😛 😜 😝
stop	stop ⏱️ ⏹️ ✋ 🙈 🙉 🙊 🚏 🛑
storm	storm ☔️ ⛈ 🌩 🌪 🌫
straight	straight 📏 🤨 😐 😑
stressed	stressed 😥 😩 😫 😰
string	string 🎸 🎻 🧵 🪕
struggling	struggling 😖 😣 😩 😫
studying	studying 📖 📚 🙇‍♀️ 🙇‍♂️
summer	summer ☀️ ⛱️ 🌞 🍉
sun	sun ☀️ ⛅️ 🌄 🌅 🌇 🌞 🌤 🌥 🌦 👒 🕶 🧴
sunny	sunny ☀️ 🌞 🍳 😎
superpower	superpower 🦸‍♀️ 🦸‍♂️ 🦹‍♀️ 🦹‍♂️
superpowers	superpowers 🦸‍♀️ 🦸‍♂️ 🦹‍♀️ 🦹‍♂️
supplies	supplies ✂️ 📁 📂 📃 📄 📅 📆 📇 📈 📉 📊 📋 📌 📍 📎 📏 📐 📑 📜 📤 📥 🖇 🗂 🗃 🗄 🗒 🗓 🗳
surprised	surprised 😦 😧 😨 😮 😯 😱 😲 😳 🙀 🙆‍♀️ 🙆‍♂️ 🙊 🙎‍♀️ 🙎‍♂️
sweat	sweat 💦 🥵 😅 😓 😥 😪 😰
sweating	sweating 🥵 😅 😓 😥 😰
sweet	sweet 🍠 🍡 🍦 🍧 🍨 🍩 🍪 🍫 🍬 🍭 🍮 🍯 🍰 🎂
sweets	sweets 🍫 🍬 🍭 🥮 🧁
swim	swim 🏊‍♀️ 🏊‍♂️ 👙 🩲 🩳
symbol	symbol 〰️ ‼️ ⁉️ *️⃣ #️⃣ 〽️ ©️ ®️ ↔️ ↕️ ↖️ ↗️ ↘️ ↙️ ↩️ ↪️ ⏩ ⏪ ⏫ ⏬ ⏭️ ⏮️ ⏯️ ⏸️ ⏹️ ⏺️ ▶️ ◀️ ☢️ ☣️ ☦️ ☪️ ☮️ ☯️ ☸️ ♈️ ♉️ ♊️ ♋️ ♌️ ♍️ ♎️ ♏️ ♐️ ♑️ ♒️ ♓️ ♨️ ♻️ ♾️ ♿️ ⚛️ ⚜️ ⚠️ ⛎ ⛔️ ⛽️ ✅ ✔️ ✖️ ✝️ ✡️ ✨ ✳️ ✴️ ❇️ ❌ ❎ ❓ ❔ ❕ ❗️ ➕ ➖ ➗ ➡️ ➰ ➿ ⤴️ ⤵️ ⬅️ ⬆️ ⬇️ ⭕️ 🀄️ 🃏 🌀 🌐 🎦 🎴 🎵 🎶 🏧 👁‍🗨 💋 💟 💠 💢 💤 💥 💮 💯 💱 💲 💹 📛 📢 📣 📳 📴 📵 📶 🔀 🔁 🔂 🔃 🔄 🔅 🔆 🔇 🔈 🔉 🔊 🔔 🔕 🔗 🔙 🔚 🔛 🔜 🔝 🔞 🔟 🔠 🔡 🔢 🔣 🔤 🔯 🔰 🔱 🔼 🔽 🕉 🕎 🚫 🚭 🚮 🚯 🚱 🚳 🚷 🚸 🚹 🚺 🚻 🚼 🚾 🛂 🛃 🛄 🛅 🛐 0️⃣ 1️⃣ 2️⃣ 3️⃣ 4️⃣ 5️⃣ 6️⃣ 7️⃣ 8️⃣ 9️⃣ 🅰️ 🆎 🅱️ 🆑 🆒 🆓 ℹ️ 🆔 Ⓜ️ 🆕 🆖 🅾️ 🆗 🅿️ 🆘 ™️ 🆙 🆚 🈁 🈂️ 🈹 🉑 🈴 🈺 🉐 🈯️ 🈷️ 🈶 🈵 🈚️ 🈸 ㊗️ 🈲 ㊙️ 🈳
symbols	symbols ☦️ ♾️ ✝️ 🔄 🤬
table	table 🍴 🍽 🏓 🧂
take	take 🎬 🛀 🛁 🛫
taking	taking 💉 📝 🤳 🚶‍♂️ 🚿
tears	tears 💦 🤣 😂 😭
technology	technology ⌚️ ⌨️ 🎞 🎥 👨‍💻 👩‍💻 💻 💽 💾 💿 📀 📱 📲 📷 📸 📹 📼 📽 🕹 🖥 🖨 🖱 🖲
that	that ☺️ 😀 😁 😃 😄 😅 🙂
the	the 🇦🇪 🇦🇽 🇧🇶 🇨🇨 🇨🇩 🇨🇫 🇨🇬 🇨🇰 🇨🇳 🇨🇿 🇩🇴 🇫🇰 🇫🇴 🇬🇧 🇮🇨 🇮🇪 🇮🇲 🇮🇴 🇰🇾 🇲🇭 🇲🇵 🇵🇸 🇸🇧 🇹🇨 🇺🇳 🇺🇸 🇻🇦 🇻🇬 🇻🇮 🌉 🗽 🚇 🚋 🚓 🚽 🛀 🛁
theme	theme 🎟 🎠 🎡 🎢
thinking	thinking 💬 💭 🤔 🙇‍♀️ 🙇‍♂️
three	three ☘️ 🎶 👨‍👦‍👦 👨‍👧‍👦 👨‍👧‍👧 👨‍👨‍👦 👨‍👨‍👧 👨‍👩‍👦 👨‍👩‍👧 👩‍👦‍👦 👩‍👧‍👦 👩‍👧‍👧 👩‍👩‍👦 👩‍👩‍👧 👪 🕒 🕞 🥴 3️⃣
time	time ⌚️ ⌛️ ⏰ ⏱️ ⏲️ ⏳ 🕐 🕑 🕒 🕓 🕔 🕕 🕖 🕗 🕘 🕙 🕚 🕛 🕜 🕝 🕞 🕟 🕠 🕡 🕢 🕣 🕤 🕥 🕦 🕧 🕰
tired	tired 💤 🥱 😌 😑 😓 😪 😰 😴
tongue	tongue 👅 🤑 😋 😛 😜 😝
too	too 🤣 🥵 😁 😂 😄
tool	tool ⚒️ ⚖️ ⚗️ ⚙️ ⛏️ ⛓️ 🔧 🔨 🔩 🔬 🔭 🖌 🗜 🛠
tools	tools ⚒️ 🍴 🍼 🍽 🧰 🪓 🛠
toy	toy 🧸 🪀 🪁 🚂
train	train 💺 🚂 🚃 🚄 🚅 🚆 🚈 🚉 🚊 🚋 🚝 🚞 🚟 🛤
tram	tram 🚈 🚉 🚊 🚋
transit	transit 🚃 🚄 🚅 🚈 🚋 🚝 🚟
transport	transport ⛴️ ⛵️ ⛽️ ✈️ 🏍 🏎 💺 🚀 🚁 🚂 🚃 🚄 🚅 🚆 🚇 🚈 🚉 🚊 🚋 🚌 🚍 🚎 🚏 🚐 🚑 🚒 🚓 🚔 🚕 🚖 🚗 🚘 🚙 🚚 🚛 🚜 🚝 🚞 🚟 🚠 🚡 🚤 🚥 🚦 🚨 🚲 🛥 🛩 🛫 🛬 🛳
transportation	transportation ⛴ ⛵️ ✈️ 🏍 🏎 💺 🚁 🚂 🚃 🚄 🚅 🚆 🚇 🚈 🚉 🚊 🚋 🚌 🚍 🚎 🚐 🚑 🚒 🚓 🚔 🚕 🚖 🚗 🚘 🚙 🚚 🚛 🚜 🚝 🚞 🚟 🚠 🚡 🚤 🚨 🚲 🛣 🛤 🛥 🛩 🛫 🛬 🛴 🛵 🛺
travel	travel 🏍 🗺 🧭 🧳 🚌 🚎 🚕 🚗 🚙 🚲 🛂 🛃 🛄 🛅 🛣 🛤
tree	tree 🌲 🌳 🌴 🎄 🎋
triangle	triangle ⏫ ⏬ ◀️ ⚠️ 📐 🔺 🔻 🔼 🔽
trip	trip 🏍 🚌 🚎 🚕 🚗 🚙
tropical	tropical 🌴 🌺 🍍 🍹 🏖 🏝 🐠 🥭 🦩
twinkling	twinkling ✨ ⭐️ 🌟 💖 🤩
two	two ‼️ ✌️ 🍻 🎵 🐫 👏 👐 👥 👨‍❤️‍👨 👨‍❤️‍💋‍👨 👨‍👦 👨‍👦‍👦 👨‍👧 👨‍👧‍👦 👨‍👧‍👧 👨‍👨‍👦 👨‍👨‍👦‍👦 👨‍👨‍👧 👨‍👨‍👧‍👦 👨‍👨‍👧‍👧 👨‍👩‍👦‍👦 👨‍👩‍👧‍👦 👨‍👩‍👧‍👧 👩‍❤️‍👨 👩‍❤️‍👩 👩‍❤️‍💋‍👩 👩‍👦 👩‍👦‍👦 👩‍👧 👩‍👧‍👦 👩‍👧‍👧 👩‍👩‍👦 👩‍👩‍👦‍👦 👩‍👩‍👧 👩‍👩‍👧‍👦 👩‍👩‍👧‍👧 👬 👭 👯‍♀️ 👯‍♂️ 💕 💞 🔲 🔳 🕑 🕝 🖇 🤝 🤼‍♀️ 🤼‍♂️ 🥂 🥓 🧑‍🤝‍🧑 🙌 2️⃣
uh	uh 😧 😨 😬 😰
umbrella	umbrella ☂️ ☔️ ⛱️ 🌂 🏖
undead	undead 🧛‍♀️ 🧛‍♂️ 🧟‍♀️ 🧟‍♂️
uneasy	uneasy 😟 😦 😧 😬 😳
unhappy	unhappy ☹️ 🤒 🤕 🤥 🤧 🥵 😐 😑 😒 😓 😔 😕 😖 😞 😟 😠 😡 😢 😣 😤 😥 😦 😧 😨 😩 😪 😫 😭 😮 😰 😱 😳 😵 😶 😿 🙀 🙁 🙄 🙍‍♀️ 🙍‍♂️ 🙎‍♀️ 🙎‍♂️
united	united 🇦🇪 🇬🇧 🇺🇳 🇺🇸
unnerved	unnerved 😐 😒 😕 😬
up	up ↕️ ↖️ ↗️ ⏫ ☝️ ⤴️ ⬆️ 👆 👍 📈 📉 🔝 🔥 🔺 🔼 🖕 🆙
ur	ur ☺️ 😇 😉 😍
utensils	utensils 🍴 🍼 🍽 🥄
vacation	vacation ⛱️ ⛴️ ⛵️ 🏖 🏝 💺 🗺 🚢 🚤 🛥 🛳
vegetable	vegetable 🌶 🌽 🍅 🍆 🍠 🥒 🥔 🥕 🥗 🥦 🥬
vegetables	vegetables 🌶 🌽 🍅 🍆 🍠 🥒 🥔 🥕 🥗 🥬
vegetarian	vegetarian 🌱 🌶 🌽 🍆 🍠
veggies	veggies 🌶 🌽 🍅 🍆 🍠 🥒 🥔 🥕 🥗 🥬
vehicle	vehicle ⛴️ ⛵️ ⛽️ ✈️ 🏁 🏍 🏎 💺 🚀 🚁 🚂 🚃 🚄 🚅 🚆 🚈 🚉 🚊 🚋 🚌 🚍 🚎 🚏 🚐 🚑 🚒 🚓 🚔 🚕 🚖 🚗 🚘 🚙 🚚 🚛 🚜 🚝 🚞 🚟 🚠 🚡 🚤 🚥 🚦 🚨 🚲 🛥 🛩 🛫 🛬 🛳 🛺
video	video 🎮 👾 📹 📼 🕹 🖲
volume	volume 🎚 🔇 🔈 🔉 🔊
wall	wall 📅 🕐 🕑 🕒 🕓 🕔 🕕 🕖 🕗 🕘 🕙 🕚 🕛 🕜 🕝 🕞 🕟 🕠 🕡 🕢 🕣 🕤 🕥 🕦 🕧
wash	wash 💆‍♀️ 💆‍♂️ 🧼 🧽 🛀
water	water ♋️ ♒️ ♓️ ⛲️ 🌊 🏄‍♀️ 🏄‍♂️ 🏊‍♀️ 🏊‍♂️ 🏖 🏝 🐃 💦 💧 🔫 🤽‍♀️ 🤽‍♂️ 🥅 🚣‍♀️ 🚣‍♂️ 🚰 🚾 🚿 🛶
waving	waving 👋 🤗 🙋‍♀️ 🙋‍♂️
weapon	weapon ⚔️ 💣 🔪 🗡 🛡
weather	weather ☀️ ☁️ ☂️ ☃️ ☄️ ☔️ ⚡️ ⛄️ ⛅️ ⛈️ ❄️ ⭐️ 🌀 🌊 🌑 🌒 🌓 🌔 🌕 🌖 🌗 🌘 🌙 🌚 🌛 🌜 🌝 🌞 🌟 🌡 🌤 🌥 🌦 🌧 🌨 🌩 🌪 🌫 🌬 💦 💧 💨 💫 🔥
wedding	wedding 🎩 🏩 👰 💒 🤵
wheelchair	wheelchair ♿️ 👨‍🦼 👨‍🦽 👩‍🦼 👩‍🦽 🦼 🦽
wheelchairs	wheelchairs 👨‍🦼 👨‍🦽 👩‍🦼 👩‍🦽 🦼 🦽
white	white ▫️ ◻️ ◽️ ☑️ ⚪️ ❔ ❕ ⬜️ 🏳 🐁 👨‍🦳 👩‍🦳 💮 🔘 🔳 🤍 🦯 🦳
whoa	whoa 😨 😮 😯 😲 😳
winter	winter ☃️ ⛄️ ⛷️ ❄️ 🌨 🎿 🏂 🥶
woman	woman ⛹️‍♀️ 🎽 🏃‍♀️ 🏄‍♀️ 🏊‍♀️ 🏋️‍♀️ 🏌️‍♀️ 👒 👚 👜 👡 👩 👩‍⚕️ 👩‍⚖️ 👩‍✈️ 👩‍❤️‍👨 👩‍❤️‍👩 👩‍❤️‍💋‍👩 👩‍🌾 👩‍🍳 👩‍🎓 👩‍🎤 👩‍🎨 👩‍🏫 👩‍🏭 👩‍💻 👩‍💼 👩‍🔧 👩‍🔬 👩‍🤝‍👨 👩‍🦯 👩‍🦰 👩‍🦱 👩‍🦲 👩‍🦳 👩‍🦼 👩‍🦽 👩‍🚀 👩‍🚒 👮‍♀️ 👰 👱‍♀️ 👳‍♀️ 👵 👷‍♀️ 👸 💁‍♀️ 💂‍♀️ 💃 💆‍♀️ 💇‍♀️ 🕵️‍♀️ 🤦‍♀️ 🤰 🤷‍♀️ 🤸‍♀️ 🤹‍♀️ 🤽‍♀️ 🤾‍♀️ 🦸‍♀️ 🦹‍♀️ 🧍‍♀️ 🧎‍♀️ 🧏‍♀️ 🧕 🧖‍♀️ 🧗‍♀️ 🧘‍♀️ 🧙‍♀️ 🧚‍♀️ 🧛‍♀️ 🧝‍♀️ 🧞‍♀️ 🧟‍♀️ 🙅‍♀️ 🙆‍♀️ 🙇‍♀️ 🙋‍♀️ 🙍‍♀️ 🙎‍♀️ 🚣‍♀️ 🚴‍♀️ 🚵‍♀️ 🚶‍♀️ 🚺 🚻
women	women 👩‍❤️‍👩 👩‍❤️‍💋‍👩 👩‍💻 👩‍💼 👩‍🔬 👩‍🤝‍👩 👩‍🦯 👩‍🦰 👩‍🦱 👩‍🦲 👩‍🦳 👩‍🦼 👩‍🦽 👯‍♀️ 💁‍♀️ 🕵️‍♀️ 🤼‍♀️ 🧍‍♀️ 🧎‍♀️ 🧏‍♀️ 🧖‍♀️ 🧗‍♀️ 🚺
work	work ⛑️ ✂️ 🏋️‍♀️ 🏋️‍♂️ 👮‍♂️ 👷‍♀️ 👷‍♂️ 💂‍♀️ 💂‍♂️ 💪 💼 📁 📂 📃 📄 📅 📆 📇 📈 📉 📊 📋 📌 📍 📎 📏 📐 📑 📜 📤 📥 🕵️‍♀️ 🕵️‍♂️ 🖇 🗂 🗃 🗄 🗒 🗓 🗳 😓
worker	worker 👨‍⚕️ 👨‍⚖️ 👨‍✈️ 👨‍🌾 👨‍🍳 👨‍🎓 👨‍🎤 👨‍🎨 👨‍🏫 👨‍🏭 👨‍💻 👨‍💼 👨‍🔧 👨‍🔬 👨‍🚀 👨‍🚒 👩‍⚕️ 👩‍⚖️ 👩‍✈️ 👩‍🌾 👩‍🍳 👩‍🎓 👩‍🎤 👩‍🎨 👩‍🏫 👩‍🏭 👩‍💻 👩‍💼 👩‍🔧 👩‍🔬 👩‍🚀 👩‍🚒
workers	workers 👨‍💻 👨‍💼 👨‍🔬 👩‍💻 👩‍💼 👩‍🔬
working	working 🏋️‍♀️ 🏋️‍♂️ 👨‍💻 👩‍💻 💪 😓
world	world ☀️ ☁️ ☂️ ☃️ ☄️ ☔️ ⚡️ ⛄️ ⛅️ ⛈️ ❄️ ⭐️ 🌊 🌍 🌎 🌏 🌑 🌒 🌓 🌔 🌕 🌖 🌗 🌘 🌙 🌚 🌛 🌜 🌝 🌞 🌟 🌤 🌥 🌦 🌧 🌨 🌩 🌪 🌫 🌬 💦 💧 💨 💫 🔥 🗺
worried	worried 😕 😟 😦 😧 😨 😩 😫 😰 😱 😳 🙀
wow	wow 🤩 😮 😯 😲 😳
writing	writing ✍️ ✏️ ✒️ 🎼 📝 🖊 🖋 🖍
yay	yay 👏 🥳 😀 😁 😃 😄 🙌
yellow	yellow 〽️ ⚜️ ⭐️ 🌕 🌝 🌟 🌻 🌼 🍂 🎗 🏵 🐝 🐠 👱 👱‍♀️ 👱‍♂️ 💛 🔅 🔆 🔱 🟡 🟨 🆚
you	you ☺️ 😅 😇 😉 😍
zodiac	zodiac ♈️ ♉️ ♊️ ♋️ ♌️ ♍️ ♎️ ♏️ ♐️ ♑️ ♒️ ♓️ ⛎ 🏺 🐂 🐍 🐏 🐐 🐟 🦀 🦂
zoo	zoo 🐒 🐨 🐯 🐻 🐼 🦁 🦍
